丨	aaai
丿	aaaj
丶	aaal
卩	aadi
冂	aaid
刂	aaij
勹	aajd
亻	aaji
匚	aakq
冫	aalk
亠	aalk
冖	aalz
讠	aalz
凵	aaqi
阝	aawi
纟	acck
丬	alki
疒	alkl
氵	allk
灬	alll
宀	allz
礻	alzi
衤	alzi
辶	alzl
虍	aikz
忄	aill
犭	ajjj
彡	ajjj
攵	ajkj
钅	ajkk
饣	ajzc
夂	ajzl
艹	akii
廾	akji
扌	akjk
屮	aqii
彐	atkk
肀	atkk
廴	awll
衣	a
竹	aa
笪	aabk
簪	aacb
篆	aacc
筐	aace
篚	aaci
篥	aacm
笞	aaco
笸	aaco
簟	aacr
箧	aacy
箅	aadi
笥	aado
笤	aado
笆	aadu
簋	aaeh
箫	aaei
笋	aaej
篡	aafc
算	aafh
篾	aafl
筚	aafr
箩	aafs
纂	aafw
竺	aag
箸	aagb
筠	aagd
等	aagl
笺	aagl
箐	aagn
箦	aagy
篝	aahg
箭	aahj
筑	aahl
箬	aaho
筇	aahp
簧	aahy
箕	aahy
筮	aahy
簸	aahz
箔	aaib
笛	aaid
筛	aaie
篮	aaih
簿	aail
筅	aajb
篼	aajb
篁	aaje
笔	aajf
篦	aajf
笙	aajg
笊	aajl
笈	aajq
筵	aajq
笑	aajv
笄	aakh
竿	aakr
竽	aakr
策	aakw
筻	aakx
籁	aaky
簌	aaky
简	aalb
簏	aalf
篇	aalh
箱	aamf
笨	aamk
笕	aanb
箜	aanh
筒	aano
筋	aanp
箢	aanp
管	aanu
篑	aaoy
篪	aapj
笳	aapo
笾	aapq
籍	aarb
籀	aard
箍	aare
箝	aark
筘	aaro
箨	aarr
筢	aaru
笫	aasi
笏	aasj
筝	aasj
箴	aasl
笱	aaso
篷	aasq
筏	aatl
符	aatl
笃	aats
筱	aats
篌	aatv
筹	aavl
笼	aavl
第	aawi
筲	aawn
筷	aawv
簦	aaxh
笮	aaya
筌	aaye
签	aayk
答	aayo
箪	aayr
簖	aayt
篓	aayx
笠	aaz
饩	aaz
篱	aazc
篙	aazo
簇	aazv
馄	abff
馒	abfz
神	abi
袒	abk
裸	abm
裼	absj
褐	absq
祧	abx
蚀	ac
馏	acdd
祗	ackl
饴	aco
初	ad
褶	addb
祠	adko
饲	adko
缶	ae
裉	aea
褪	aeaq
馊	aeez
缸	aeh
罐	aehg
禄	aei
制	aej
裙	aejo
掣	aejr
罅	aepj
缺	aetv
饵	afr
社	ag
裱	aga
褂	aggi
褚	agjb
饯	agxl
馍	ahbv
饼	ahh
祺	ahky
馓	ahns
馑	ahog
袢	ahr
褡	ahyo
补	ai
袖	aid
褴	aiih
祯	ainy
饥	aj
裨	ajbi
衫	ajjj
褫	ajpj
衽	ajrk
饪	ajrk
饿	ajrl
饭	ajs
祈	ajt
袄	ajv
饫	ajv
馁	ajx
饨	ake
褙	akfn
袜	akkm
福	akod
祆	akv
饶	akxb
裥	alnb
褊	alph
裤	alsr
馇	ambk
襟	ammw
襻	amxr
视	anb
祖	ank
饷	ano
馆	anpu
衲	any
裔	anyo
祝	aob
裎	aoe
馈	aogy
祸	aony
祁	ap
裾	apro
被	apz
祛	arc
禊	ardv
禧	arko
衬	arl
饽	arnk
祜	aro
馕	aroa
饱	ascu
馅	asee
褥	askl
馋	asol
袼	asqo
袍	asuu
祢	asw
饮	asy
褓	atom
袂	atv
袱	atvl
襦	atxi
礼	au
祀	auu
馔	auuy
祉	av
卸	avp
祷	avrl
裢	avrq
祓	avzl
裆	awe
饧	awjj
襁	awoc
禅	aybr
饰	aye
禚	ayew
裣	aykk
馀	aykm
袷	ayko
衿	aylz
褛	aymx
饬	aypp
祥	ayt
馐	aytg
裕	ayyo
气	az
氲	azbh
氤	azdv
氙	aze
氯	azei
氰	azgn
氕	azj
氚	azji
氘	azji
氖	azjw
氩	azkk
衩	azl
氨	aznx
禳	azoa
氪	azrb
氡	azsl
氟	azwi
氛	azyd
氧	azyt
饺	azyx
氮	azyy
氢	azzh
氦	azzy
裰	azzz
日	b
昌	bb
晶	bbb
曝	bbhi
晁	bbx
晒	bcc
昴	bcjp
昂	bcp
曜	bddg
遢	bddq
昭	bdo
照	bdow
旺	be
曳	bf
昆	bff
曙	bfgb
最	bfrz
曼	bfz
里	bg
墅	bgdg
野	bgdj
暑	bgjb
晴	bgn
暴	bhyi
申	bi
曲	bii
显	biik
畅	biwj
星	bjg
戥	bjgl
曛	bjkw
暧	bjnz
昕	bjt
暖	bjtz
旦	bk
量	bkbg
昙	bkc
晟	bkdl
昧	bkm
晡	bkni
旰	bkr
旱	bkr
昊	bkv
是	bkv
匙	bkvf
韪	bkvp
题	bkvy
晓	bkxb
旷	bls
杲	bm
果	bm
晰	bmjt
夥	bmss
颗	bmty
明	bn
暝	bnby
禺	bnc
遇	bncq
愚	bncu
暄	bnkk
盟	bnnh
晌	bno
映	bnv
晖	bnvr
晕	bnvr
晏	bnx
暇	bpgz
昵	bpf
早	br
时	brl
昀	bsd
剔	bsjj
易	bsjj
晨	bska
晚	bsob
煦	bsow
晷	bsqo
昃	bsy
遏	bsyq
曷	bsyq
歇	bsyy
晔	btfr
晤	btho
暹	btzq
电	bu
旯	bu
晃	bwkb
胤	bwn
兆	bx
暌	bxkv
逃	bxq
鼗	bxrz
晦	bydr
曦	byel
昨	byk
晗	bylo
炅	byy
昱	bz
暗	bzb
曩	bzoa
景	bzw
晾	bzw
影	bzwj
暾	bzws
颢	bzwy
虫	c
匹	cb
允	cb
蛐	cbii
蜾	cbm
蜴	cbsj
蝎	cbsq
郾	cbxp
西	cc
覃	ccbr
巛	ccc
甾	cccd
垒	cccg
剿	cccj
巢	cccm
邋	cccq
巡	cccq
邕	cccu
螵	cccw
蛭	ccg
剽	ccgj
瓢	ccgl
甄	ccgl
鄄	ccgp
票	ccgw
飘	ccgx
蚜	cci
蛑	ccjr
覆	ccjs
酉	cck
栗	ccm
贾	ccny
要	ccx
粟	ccym
留	cdd
遛	cddq
蝈	cdel
匣	cdi
蛹	cdn
贸	cdny
蛔	cdo
螺	cdww
匡	ce
匝	ce
螋	ceez
蚍	cff
蠼	cffz
至	cg
蛙	cgg
到	cgj
蜻	cgn
郅	cgp
致	cgs
臻	cgvm
弁	ch
虹	ch
互	ch
蜡	chb
螬	chbb
蟆	chbv
蠛	chfl
蟥	chiy
蠡	chjc
彖	chjc
蚶	chk
蜞	chky
蠓	chnc
蝾	chnm
螨	chny
蝶	chqm
蠖	chtz
蟒	chvh
匿	chvo
蜷	chvp
慝	chvu
彘	chyf
彝	chyh
牙	ci
蚰	cid
匪	cii
蛳	cije
鸦	cioq
邪	cip
孵	cipk
卵	cipl
迓	ciq
雅	citg
虮	cj
蝗	cjbe
蜱	cjbi
卿	cjep
螅	cjfu
蚝	cjkf
蟠	cjmd
蜊	cjmj
蝌	cjmr
蟋	cjmu
蚯	cjo
卯	cjp
蛾	cjrl
蛞	cjro
蜓	cjrq
牟	cjrr
匠	cjt
蜒	cjvq
蜉	cjwk
蟪	ckbu
蛱	ckhy
虾	cki
蝠	ckod
蜮	ckol
鸱	ckoq
氏	cku
昏	ckub
氐	ckul
邸	ckup
蛲	ckxb
厶	cl
虻	clc
蛀	cle
螂	clep
蚪	cllr
蝙	clph
匾	clph
蠊	clsi
螗	clso
以	cly
蜥	cmjt
蚬	cnb
螟	cnby
蛇	cnf
能	cnff
熊	cnfw
蚺	cng
蜩	cngo
蛊	cnh
蛆	cnk
蜿	cnsp
蚋	cny
叵	co
台	co
蝇	cobu
匮	cogy
蜈	cokv
蜗	cony
邰	cop
迨	coq
怠	cowu
炱	coyy
迎	cpq
蚌	cr
蟛	crkj
蝻	crnr
蛄	cro
蝴	cron
螈	csjw
蛎	cskd
蟓	csoc
蜂	csqr
蟾	cssl
蚵	cto
蚂	cts
蠕	ctxi
巨	cu
虬	cu
蝽	cvb
畚	cvd
蝰	cvgg
叁	cvgk
毵	cvjf
参	cvjj
螓	cvjm
匦	cvru
蚨	cvv
乐	cw
蚓	cwi
蜢	cwkh
蛸	cwn
螳	cwng
蚴	cwpp
区	cx
瓯	cxcl
殴	cxjz
蚁	cxl
鸥	cxoq
欧	cxsy
臣	cy
蝉	cybr
蝮	cybs
蚣	cyc
蜣	cyeb
赜	cygy
卧	cyi
蚧	cyji
蚱	cyk
蛤	cykd
蝓	cykj
蜍	cykm
蛉	cyld
蛛	cym
蝼	cymx
蜕	cyob
逡	cysq
皴	cysz
蛘	cyt
蟮	cyto
颐	cyty
蝤	cyu
熙	cyuw
医	cyv
矣	cyv
翳	cyvd
蜘	cyvo
虼	cyz
蟑	czbr
蝣	czdk
蛏	czg
瓦	czl
蟀	czwr
蚊	czx
螭	czxc
蛴	czxi
蛟	czyx
螃	czzd
田	d
畏	da
四	db
冱	dch
冶	dco
习	dd
囗	dddd
羽	dddd
翟	dddg
羿	dddh
戳	dddl
戮	dddl
翠	dddr
翼	dddy
翌	dddz
鹨	ddoq
国	del
毗	dff
圜	dfka
凝	dfyv
园	dgb
畦	dgg
圉	dghr
圊	dgn
围	dgp
凌	dgys
畔	dhr
圈	dhvp
冰	di
甲	di
鸭	dioq
刀	dj
眉	djf
冼	djgb
鹛	djoq
畈	djs
刁	dk
囤	dke
曰	dkkk
圃	dkni
司	dko
冽	dksj
刃	dl
忍	dlwu
困	dm
凇	dmyc
胃	dn
甬	dn
凋	dngo
勇	dnpp
通	dnq
畹	dnsp
回	do
召	do
况	dob
冲	doi
圆	dony
邵	dop
劭	dopp
迢	doq
男	dpp
嬲	dppp
母	dr
凄	drex
团	drj
贯	drny
固	dro
畋	ds
净	dsej
囫	dsjj
减	dskl
图	dsql
略	dsqo
次	dsy
盗	dsyh
瓷	dsyl
粢	dsym
咨	dsyo
恣	dsyu
姿	dsyx
资	dsyy
町	dt
圄	dtho
畀	dti
冯	dts
决	dtv
准	dtzg
巴	du
乜	du
毋	dv
因	dv
凑	dvkv
畎	dvl
囿	dvn
那	dvp
畴	dvrl
畸	dvto
冻	dvw
恩	dvwu
囝	dwk
思	dwu
累	dww
囡	dx
囚	dy
囵	dyf
界	dyji
畛	dyjj
冷	dyld
囹	dyld
疃	dzbg
凛	dzdw
矛	dzi
蝥	dzic
蟊	dzic
瞀	dzif
柔	dzim
鍪	dziq
婺	dzix
矜	dziz
予	dzj
豫	dzjc
预	dzjy
鹜	dzoq
鹬	dzoq
骛	dzts
凉	dzw
巾	e
艮	ea
垦	eag
退	eaq
恳	eawu
琨	ebff
幔	ebfz
理	ebg
幌	ebwb
珧	ebx
既	eccb
暨	ecck
瑙	eccx
崾	eccx
岈	eci
琊	ecip
峁	ecjp
即	ecp
岖	ecx
峻	ecys
帼	edel
岬	edi
嵋	edjf
崮	edro
岜	edu
崽	edwu
臼	ee
鼢	eecd
鼬	eecd
鼯	eeco
鼠	eecu
鼷	eecv
鼹	eecx
舅	eedp
琶	eedu
琵	eeff
舁	eeh
毁	eehz
叟	eeiz
珏	eel
舄	eesw
璀	eetg
瑞	eeti
瑟	eewf
臾	eey
琴	eeyz
珥	efr
嶷	efyv
玩	egb
帻	egny
帏	egp
玮	egp
峙	egrl
弄	eh
璜	ehiy
琪	ehky
嵌	ehky
嵘	ehnm
崂	ehnp
瑛	ehnv
瑾	ehog
嵫	ehww
珙	ehy
隶	ei
录	ei
岫	eid
班	eie
盥	eieh
幞	eiiv
璞	eiiv
剥	eij
岿	eije
帧	einy
玷	eio
帖	eio
逮	eiq
逯	eiq
璨	eism
玑	ej
尹	ej
瑶	ejae
帕	ejb
珀	ejb
瑰	ejbc
嵬	ejbc
碧	ejbo
璁	ejdu
瓒	ejgy
帆	ejl
巍	ejmc
幡	ejmd
嵊	ejmf
瑷	ejnz
君	ejo
郡	ejop
群	ejot
岌	ejq
峨	ejrl
帐	ejrl
珩	ejtt
踅	ejtv
瑗	ejtz
峤	ejvi
帙	ejvv
岚	ejx
蚩	ekc
岍	ekh
峡	ekhy
球	ekil
豳	ekjc
琢	ekjc
岩	eko
幅	ekod
环	ekw
崃	ekym
玉	el
琉	elcu
琅	elea
瑭	elso
琳	emm
崧	emyc
岘	enb
现	enb
帚	ene
瑁	engb
帽	engf
崇	engw
琮	engw
峒	enko
崩	enn
珊	ennk
琬	ensf
珲	envr
岗	enx
崆	enyh
琛	enym
璎	enyx
噩	eooo
璐	eovo
帜	eoy
印	ep
幄	epcg
崛	epeu
璩	epfc
琥	epfj
瑕	epgz
岷	epku
珉	epku
珈	eppo
琚	epro
玻	epz
帔	epz
珐	erc
寻	erl
巅	erny
岵	ero
瑚	eron
聿	err
建	errq
岐	erz
玫	es
岁	es
峋	esb
峥	esej
崖	esgg
刿	esj
屿	esk
崴	eskl
岸	eskr
玖	esll
岣	eso
珞	esqo
峰	esqr
玎	et
屺	etc
岂	etc
觊	etcb
剀	etcj
凯	etcj
玳	etkl
遄	etnq
颛	etny
顼	etny
珂	eto
岢	eto
玛	ets
崔	etzg
帷	etzg
出	eu
祟	eugw
粜	euym
崦	evbu
帱	evrl
琏	evrq
崭	evrt
崎	evto
琦	evto
岽	evw
珑	evxl
炭	evyy
肃	ewji
峭	ewn
琐	ewny
嶝	exkh
崤	exvn
玢	eyd
珍	eyjj
嵛	eykj
瑜	eykj
玲	eyld
岭	eyld
岑	eylz
珠	eym
嶙	eymi
嵝	eymx
嵯	eyth
嵴	eyxn
灵	eyy
峪	eyyo
琰	eyyy
屹	eyz
幢	ezbg
璋	ezbr
嶂	ezbr
幛	ezbr
璇	ezdv
嵩	ezno
峄	ezrr
琼	ezw
崞	ezwk
玟	ezx
璃	ezxc
斑	ezxe
目	f
旨	fb
眺	fbx
瞟	fccw
眶	fce
眸	fcjr
眙	fco
眍	fcx
睃	fcys
切	fd
眼	fea
睨	feeb
瞍	feez
肆	ferr
比	ff
癯	fffg
皆	ffjb
毙	ffkf
毕	ffr
氍	fftf
瞿	fftg
矍	fftz
毖	ffwf
眭	fgg
睹	fgjb
署	fgjb
睛	fgn
睦	fgyg
瞄	fhd
瞒	fhny
羁	fhts
罩	fibr
罪	fii
颍	fity
罹	fiyg
身	fj
睥	fjbi
躯	fjcx
鬟	fjja
髡	fjjb
髦	fjjf
髭	fjjf
髯	fjjg
髟	fjjj
躲	fjjm
髹	fjjm
髻	fjjo
髫	fjjo
鬈	fjjp
鬣	fjju
鬃	fjjw
鬓	fjjy
鬏	fjjy
睡	fjkg
眨	fjlz
睬	fjm
瞅	fjmy
颖	fjmy
瞬	fjni
射	fjrl
躬	fjw
躺	fjwo
盹	fke
睫	fkev
段	fkjz
鼎	fkk
盱	fkr
罡	fkv
罘	fkw
睐	fkym
詈	fl
罚	flj
眈	fnb
瞑	fnby
瞎	fnro
瞩	fpjc
眠	fpku
耳	fr
罢	frc
瞌	frch
聊	frcp
罴	frcw
联	frhv
聘	fris
聒	frjo
耽	frnb
聃	frng
置	frnk
罱	frnr
聍	frnt
罟	fro
鸨	froq
聩	froy
职	froy
耶	frp
耵	frt
耻	frv
聆	fryd
聪	fryu
耿	fryy
取	frz
聚	frzi
鄹	frzp
娶	frzx
颞	frzy
聂	frzz
罗	fs
蜀	fsc
睁	fsej
睚	fsgg
逻	fsq
眵	fss
瞻	fssl
盯	ft
瞰	ftfs
顷	ftny
眄	ftqd
睢	ftzg
瞧	ftzw
罨	fvbu
眦	fvf
眇	fwj
瞠	fwng
瞪	fxkh
睽	fxkv
盼	fyd
罾	fydb
睑	fykk
眯	fym
瞵	fymi
肄	fyvr
疑	fyvv
睇	fywi
瞳	fzbg
眩	fzw
土	g
表	ga
裁	gaxl
元	gb
塌	gbdd
墁	gbfz
埋	gbg
坤	gbi
坦	gbk
堤	gbkv
鼋	gbou
远	gbq
埘	gbrl
埸	gbsj
顽	gbty
堰	gcbx
堙	gccg
垤	gcg
坻	gckl
埃	gcyv
戴	gdhl
毒	gdr
坶	gdr
纛	gdrw
敖	gds
螯	gdsc
鳌	gdsd
獒	gdsl
遨	gdsq
鏊	gdsq
聱	gdsr
熬	gdsw
赘	gdsy
骜	gdts
垠	gea
埭	gei
埽	gene
垲	getc
戋	gfl
盏	gflh
塄	gfzd
圭	gg
卦	ggi
堵	ggjb
封	ggrl
圬	ggs
恚	ggwu
堪	ghcy
坩	ghk
堞	ghqm
幸	ghr
塔	ghyo
墚	gidm
赤	gii
赭	giib
螫	giic
赫	giii
郝	giip
赦	giis
赧	giiz
盐	ginh
坫	gio
垆	gip
者	gjb
翥	gjbd
埤	gjbi
都	gjbp
煮	gjbw
老	gjf
耆	gjfb
耄	gjff
耋	gjfg
亓	gji
圳	gjii
垢	gjko
垛	gjm
埠	gjpr
圾	gjq
芨	gjq
埒	gjrl
坂	gjs
考	gjs
圻	gjt
坼	gjtl
埏	gjvq
孝	gjwk
教	gjws
三	gk
垣	gkbk
埂	gkbx
坛	gkc
城	gkdl
坪	gkhi
垭	gkik
埔	gkni
塥	gkoi
域	gkol
圩	gkr
坏	gkw
坯	gkwk
圹	gls
墉	glsi
塘	glso
栽	gmxl
青	gn
坨	gnf
垸	gngb
垌	gnko
堋	gnn
靓	gnnb
靛	gnnv
垧	gno
静	gnsj
坝	gny
责	gny
坍	gnz
袁	goa
埕	goe
埚	gony
埙	gony
哉	goxl
韦	gp
韫	gpbh
韧	gpdl
堀	gpeu
坭	gpf
墟	gpfk
墀	gpir
韬	gpje
违	gpq
地	gpu
坡	gpz
墙	grho
寺	grl
埴	grnk
填	grny
亏	gs
均	gsd
塬	gsjw
堍	gsol
坜	gspp
麦	gsq
坞	gssk
麸	gsvv
坎	gsy
圮	gtc
堠	gthv
坷	gto
块	gtv
堆	gtzg
截	gtzl
圯	guu
址	gv
走	gv
埯	gvbu
越	gvcl
超	gvdo
趑	gvdy
垅	gvfl
趣	gvfz
垮	gvgs
赴	gvi
趱	gvjy
趔	gvkj
赶	gvkr
趄	gvnk
鹉	gvoq
载	gvrl
趋	gvse
起	gvtc
赳	gvu
武	gvul
趟	gvwo
赵	gvx
趁	gvyj
示	gw
场	gwjj
坳	gwpp
素	gww
增	gydb
逵	gygq
埝	gylu
圪	gyz
垃	gz
境	gzbb
坊	gzd
坑	gzj
壕	gznc
培	gzo
壤	gzoa
垓	gzuy
墩	gzws
坟	gzx
垴	gzxu
墒	gzyo
廿	h
昔	hb
曹	hbb
菖	hbb
遭	hbbq
蔓	hbfz
蕞	hbfz
酆	hbkp
萌	hbn
鹊	hboq
草	hbr
莳	hbrl
葛	hbsq
蓦	hbts
莫	hbv
暮	hbvb
幕	hbve
墓	hbvg
募	hbvp
摹	hbvr
慕	hbvw
茧	hc
茜	hcc
蕈	hccr
茂	hcfl
芽	hci
茆	hcjp
芪	hcku
苡	hcly
苔	hco
茚	hcp
苣	hcu
甚	hcy
戡	hcyl
勘	hcyp
斟	hcyr
苗	hd
蓼	hddj
菌	hdjm
茴	hdo
苕	hdo
鹋	hdoq
茨	hdsy
芭	hdu
茵	hdv
蒽	hdvu
葸	hdwu
茅	hdzi
蓣	hdzy
茛	hea
萸	heey
兼	heii
萜	heio
歉	heiy
朔	hen
塑	heng
槊	henm
鹣	heoq
逆	heq
荨	herl
茁	heu
萧	hewi
苜	hf
芘	hff
蒈	hffb
荜	hffr
薯	hfgb
蕻	hfhy
薨	hfnf
瞢	hfnf
甍	hfnl
茸	hfr
萝	hfs
蔑	hfsl
兰	hg
芏	hg
芫	hgb
葑	hggl
蓍	hgjb
著	hgjb
菁	hgn
苇	hgp
莰	hgsy
蒜	hgww
菱	hgys
并	hh
瓶	hhcl
葚	hhcy
蒹	hhei
蒴	hhen
横	hhiy
苷	hhk
萁	hhky
迸	hhq
汞	hi
卅	hi
蕖	hicm
黄	hidy
茳	hih
菲	hii
普	hiib
蓝	hiih
蒎	hija
藩	hijd
萍	hiki
蒲	hiki
薄	hikl
菽	hikz
蒗	hila
茫	hilc
菹	hink
苫	hio
藻	hiom
范	hip
菠	hipz
落	hiso
菏	hito
荡	hiwj
莎	hiwj
蔸	hjbb
萆	hjbi
葩	hjbu
遂	hjcq
蓖	hjdf
首	hjf
馘	hjfl
道	hjfq
夔	hjfs
藐	hjjb
董	hjkg
薰	hjkw
巩	hjl
蛩	hjlc
銎	hjlq
恐	hjlu
跫	hjlv
菜	hjm
蕃	hjmd
藜	hjmi
莉	hjmj
莠	hjmw
萎	hjmx
孽	hjpk
蘖	hjpm
薛	hjpr
芊	hjr
苌	hjrl
莪	hjrl
莛	hjrq
芹	hjt
蘅	hjtt
荇	hjtt
蓰	hjtv
荞	hjvi
艿	hjw
莩	hjwk
荽	hjx
芟	hjz
甘	hk
蕙	hkbu
芸	hkc
芾	hke
苹	hkhi
荆	hkhj
荚	hkhy
蕤	hkjg
藏	hkkl
茉	hkkm
某	hkm
莆	hkni
蔌	hkoy
邯	hkp
芋	hkr
巧	hks
葬	hksh
薤	hksk
蒋	hksl
蔫	hkvw
苤	hkwk
荑	hkwy
荛	hkxb
其	hky
基	hkyg
莱	hkym
期	hkyn
斯	hkyt
綦	hkyw
欺	hkyy
蔼	hlbq
芒	hlc
茺	hlcb
荒	hlcu
莨	hlea
蔺	hlng
芦	hlp
蘼	hlsi
蘑	hlso
蔗	hlsw
芝	hlz
葙	hmf
菥	hmjt
苯	hmk
菘	hmyc
苋	hnb
萤	hnc
带	hne
莹	hnel
苒	hng
茔	hng
觏	hngb
莞	hngb
蒙	hngc
遘	hngq
蔻	hngz
藤	hnhi
荥	hni
前	hnj
剪	hnjd
翦	hnjd
荦	hnjr
煎	hnjw
苴	hnk
苎	hnk
萱	hnkk
菪	hnko
茼	hnko
荣	hnm
蒯	hnnj
苘	hno
营	hnoo
莺	hnoq
劳	hnpp
菅	hnpu
菔	hnpz
蓥	hnq
散	hns
菀	hnsp
蓿	hntb
英	hnv
荤	hnvr
萦	hnww
贡	hny
芮	hny
蓉	hnyo
颟	hnyy
荧	hnyy
茕	hnzr
蕺	hofl
葺	hofr
堇	hog
觐	hogb
勤	hogp
鄞	hogp
蒉	hogy
燕	hokw
莴	hony
莒	hoo
鹳	hooq
萼	hoos
颧	hooy
茑	hoq
革	hor
鞔	horb
靴	horf
鞲	horg
鞋	horg
鞒	hori
靼	hork
鞯	hork
鞫	horl
鞠	horm
鞣	horm
鞴	horn
鞘	horn
勒	horp
鞑	horq
靳	hort
靶	horu
鞅	horv
鞍	horx
鞭	horx
节	hp
邛	hp
蘧	hpfq
葭	hpgz
蔚	hpgl
苠	hpku
荩	hpll
荫	hpn
薜	hpor
功	hpp
茄	hppo
荔	hppp
苏	hppy
蒺	hpyv
萨	hpzj
世	hq
贳	hqny
半	hr
葜	hrdv
萋	hrex
蔷	hrho
薹	hrkg
荸	hrnk
苦	hro
葫	hron
菝	hrvl
藉	hryb
藕	hryc
芰	hrz
攻	hs
萄	hsae
荀	hsb
蓟	hsdj
藓	hsdt
萏	hsee
蕨	hshy
芴	hsjj
葡	hski
蓐	hskl
葳	hskl
芍	hsl
蒇	hsnl
苟	hso
茗	hso
警	hsol
菟	hsol
檠	hsom
擎	hsor
敬	hsos
苊	hsp
苑	hsp
苈	hspp
蓬	hsqq
苞	hsuu
葱	hsxu
芡	hsy
菊	hsym
花	htf
芑	htf
莜	htis
荏	htjk
项	htny
苛	hto
葆	htom
茌	htrk
苻	htrl
荷	htto
芜	htu
茯	htvl
蕾	htxd
藿	htxg
薷	htxi
莅	htz
萑	htzg
劐	htzj
蓓	htzo
蕉	htzw
艽	hu
豢	hukc
芄	hul
蘸	hutw
关	hv
芷	hv
券	hvd
茈	hvf
眷	hvf
茏	hvfl
萘	hvgw
茬	hvig
荐	hvik
蓁	hvjn
誊	hvl
莽	hvlh
桊	hvm
若	hvo
惹	hvou
卷	hvp
郑	hvp
送	hvq
拳	hvr
莲	hvrq
鲞	hvsd
芙	hvv
寮	hvyw
茇	hvzl
芎	hw
蕴	hwbh
荭	hwh
芗	hwj
莼	hwke
菰	hwkl
芤	hwku
荪	hwkw
鹚	hwoq
荮	hwrl
药	hwsl
芯	hwu
蕊	hwuu
兹	hww
孳	hwwk
慈	hwwu
菡	hwxu
蒸	hwxw
艾	hx
蔡	hxgw
获	hxjl
莸	hxjl
荻	hxjy
葵	hxkv
茹	hxo
菇	hxro
薅	hxsl
共	hy
蕲	hybt
蓊	hycd
芬	hyd
莓	hydr
蘩	hydw
荃	hye
蔽	hyes
芥	hyji
荟	hykc
莶	hykk
荼	hykm
蔹	hyks
苓	hyld
芩	hylz
茶	hym
茱	hym
薮	hyms
蒌	hymx
蠲	hync
益	hynh
苍	hyp
巷	hyp
恭	hyw
苁	hyy
巫	hyy
觋	hyyb
艺	hz
薏	hzbu
芳	hzd
菸	hzdl
蔟	hzdv
蒂	hze
茎	hzh
苄	hzi
蓑	hzka
荬	hzlv
薪	hzmt
藁	hznm
蒿	hzno
葶	hznt
菩	hzo
莘	hzr
蔬	hzvu
蓄	hzwd
蕹	hzwg
蓠	hzxc
荠	hzxi
萃	hzyr
茭	hzyx
蒡	hzzd
水	i
滗	iaaf
汔	iaz
汽	iaz
汩	ib
旧	ib
汨	ib
沓	ib
溻	ibdd
混	ibff
漫	ibfz
涅	ibg
瀑	ibhi
澧	ibih
湿	ibik
桌	ibm
温	ibnh
卓	ibr
渴	ibsq
洮	ibx
灏	ibzy
汇	ic
浊	ic
洒	icc
淄	iccd
湮	iccg
溧	iccm
潭	iccr
漂	iccw
溜	icdd
泖	icjp
治	ico
渠	icum
渗	icvj
泺	icw
沤	icx
浚	icys
由	id
泗	idb
濯	iddg
涠	idgp
湄	idjf
溷	idkc
涩	idlv
渭	idn
涌	idn
胄	idn
洄	ido
沼	ido
邮	idp
迪	idq
涸	idro
淠	idti
卣	idu
洇	idv
漯	idww
卤	idx
鹾	idxh
泅	idy
梁	idym
粱	idym
汕	ie
汪	ie
溉	iecb
溲	ieez
渌	iei
浸	ienz
浔	ierl
津	ierr
湍	ieti
涔	ieyz
泪	if
沏	ifd
柒	ifm
洱	ifr
滠	ifrz
濉	iftg
渺	ifwj
止	ig
沅	igb
浅	igfl
洼	igg
渚	igjb
清	ign
渍	igny
污	igs
江	ih
漕	ihbb
漠	ihbv
湛	ihcy
潇	ihei
溯	ihen
潢	ihiy
泔	ihk
澌	ihkt
淇	ihky
滞	ihne
湔	ihnj
滢	ihnl
涝	ihnp
懑	ihnu
潆	ihnw
满	ihny
灌	ihog
鸿	ihoq
泄	ihq
渫	ihqm
泮	ihr
漭	ihvh
滋	ihww
洪	ihy
溢	ihyh
港	ihyp
非	ii
裴	iia
览	iiab
监	iiah
临	iiao
鉴	iiaq
淖	iibr
蜚	iic
油	iid
翡	iidd
淼	iii
州	iii
滥	iiih
洲	iiii
韭	iik
业	iik
黼	iiki
黻	iikl
邺	iikp
凿	iiku
黹	iikw
淑	iikz
浈	iiny
沾	iio
泸	iip
芈	iirr
瀣	iisk
辈	iivr
悲	iiwu
坚	iizg
肾	iizn
紧	iizw
斐	iizx
贤	iizy
竖	iizz
派	ija
泊	ijb
湟	ijbe
激	ijbs
归	ije
帅	ije
滔	ijee
洎	ijf
濞	ijfi
溴	ijfl
洗	ijgb
浩	ijgo
淫	ijjk
师	ijke
泛	ijlz
潘	ijmd
潲	ijmn
湫	ijmy
洫	ijnh
澳	ijnv
沿	ijo
浜	ijoy
汲	ijq
活	ijro
沂	ijt
沃	ijv
鋈	ijvq
涎	ijvq
湃	ijvt
浮	ijwk
溪	ijwv
渊	ijyi
没	ijz
上	ik
洹	ikbk
沌	ike
沛	ike
浇	ikfb
涞	ikhm
浃	ikhy
卡	iki
涿	ikjc
沫	ikkm
浦	ikni
溥	iknl
涑	ikow
濑	ikoy
漱	ikoy
汗	ikr
洌	iksj
添	ikvw
督	ikwf
忐	ikwu
叔	ikwz
卜	il
瀛	ilcl
鎏	ilcq
澈	ilcs
流	ilcu
泳	ildx
注	ile
浪	ilea
涧	ilnb
润	ilne
澜	ilnw
沪	ilp
沩	ilpl
漉	ilsf
濂	ilsi
溏	ilso
渡	ilsz
浒	ilyr
沐	im
渣	imbk
湘	imf
淅	imjt
沭	iml
淋	imm
潸	immn
漤	immx
淞	imyc
浓	ina
沈	inb
渖	inbi
溟	inby
淝	indu
沱	inf
浣	ingb
淙	ingw
沉	inj
滨	injy
沮	ink
睿	inkf
壑	inkg
渲	inkk
洞	inko
淀	inkv
滑	inn
涫	inpu
泻	insk
泞	int
演	inty
泱	inv
浑	invr
贞	iny
测	inyj
溅	inyl
深	inym
溶	inyo
滘	inyo
滓	inzr
占	io
渑	iobu
溃	iogy
战	iokl
涓	ion
觇	ionb
涡	iony
澡	ioom
漶	ioou
乩	iou
浞	iov
潞	iovo
点	iow
卢	ip
渥	ipcg
涮	ipej
泥	ipf
滹	ipfj
滤	ipfu
泯	ipku
鸬	ipoq
泐	ippp
漏	iptx
颅	ipty
池	ipu
潺	ipwk
滁	ipym
波	ipz
婆	ipzx
淦	iq
沣	ir
汁	ir
瀚	irbd
潮	irbn
法	irc
溘	irch
浙	irjt
澎	irkj
澍	irkl
洁	irko
渤	irnp
滇	irny
沽	iro
湖	iron
滟	irsu
渎	irzv
汐	is
淘	isae
洵	isb
沟	isc
渔	isd
涯	isgg
源	isjw
溽	iskl
涣	isnv
浼	isob
沥	ispp
洚	isqi
涤	isqm
洛	isqo
澹	issl
泡	isuu
餐	isza
粲	iszm
汀	it
湎	itdo
澉	itfs
浯	itho
濮	itiv
河	ito
沔	itqd
濡	itxi
灞	itxn
淮	itzg
凼	iu
酒	iu
山	iu
染	ium
汜	iuu
淹	ivbu
泷	ivfl
涉	ivij
濒	iviy
溱	ivjm
汰	ivl
洧	ivn
涛	ivrl
涟	ivrq
渐	ivrt
潜	ivvb
漆	ivyi
潦	ivyw
泼	ivzl
泓	iwc
溺	iwdd
泌	iwf
沙	iwj
裟	iwja
沸	iwji
汤	iwjj
涨	iwjl
挲	iwjr
娑	iwjx
烫	iwjy
消	iwn
淌	iwno
鲨	iwsd
潍	iwtg
沁	iwu
涵	iwxu
汝	ix
霪	ixik
潴	ixjb
漪	ixjo
澄	ixkh
洳	ixo
汹	ixu
浠	ixve
淆	ixvn
汾	iyd
湓	iydh
海	iydr
漾	iyex
沦	iyf
浍	iykc
瀹	iykh
渝	iykj
涂	iykm
洽	iyko
潋	iyks
溆	iykz
泠	iyld
洙	iym
瀵	iymy
沧	iyp
沲	iypu
洋	iyt
涕	iywi
滏	iyxh
浴	iyyo
惮	iyyr
淡	iyyy
汉	iz
攴	iz
泣	iz
潼	izbg
漳	izbr
澶	izdk
游	izdk
淤	izdl
漩	izdv
泾	izh
汴	izi
滦	izim
湾	iziw
沆	izj
汊	izl
濠	iznc
涪	izo
汛	izr
滴	izro
泽	izrr
滩	iztg
液	izts
泫	izw
淳	izwk
汶	izx
漓	izxc
济	izxi
浏	izxj
滚	izya
淬	izyr
滂	izzd
几	j
遥	jaeq
繇	jaew
鹞	jaoq
白	jb
魑	jbbc
鬼	jbbc
魍	jbbc
魃	jbbl
魅	jbbm
魈	jbbn
魁	jbbr
魉	jbby
兜	jbcb
卑	jbci
郫	jbcp
帛	jbe
皇	jbe
皑	jbec
遑	jbeq
皂	jbf
泉	jbi
魄	jbjc
皤	jbjd
皓	jbjo
皈	jbjs
翱	jbmd
皋	jbmk
皖	jbnb
鹎	jboq
迫	jbq
的	jbsl
邀	jbzq
敫	jbzs
皎	jbzx
么	jc
瓜	jcll
瓞	jclv
囱	jds
囟	jdx
粤	jdys
币	je
殷	jedz
舀	jee
乇	jf
自	jf
鼻	jfdi
劓	jfdj
齄	jfdk
鼾	jfdr
鼽	jfdu
爵	jfel
睾	jfgr
臬	jfm
臭	jfvl
息	jfwu
生	jg
先	jgb
选	jgbq
赞	jgby
甥	jgdp
眚	jgf
告	jgo
靠	jgoi
郜	jgop
鹄	jgoq
造	jgoq
片	jgt
升	jh
乎	jhj
八	ji
衢	jift
川	jii
顺	jiiy
爪	jill
爬	jilu
豸	jj
凰	jjbe
貂	jjdo
貘	jjhv
貌	jjjb
貔	jjjf
邈	jjjq
须	jjjy
豺	jjrj
豹	jjsl
貉	jjso
貊	jjtb
貅	jjtm
重	jkbg
秉	jkew
毛	jkf
氇	jkfb
氆	jkfb
毳	jkff
毡	jkfo
毽	jkfq
毪	jkfr
毯	jkfy
垂	jkhg
后	jko
逅	jkoq
熏	jkow
卮	jkp
手	jkr
夙	jks
凡	jl
入	jll
汆	jlli
籴	jllm
乏	jlz
采	jm
朵	jm
禾	jm
香	jmb
稞	jmbm
馥	jmbs
私	jmc
番	jmd
翻	jmdd
鄱	jmdp
稷	jmds
秽	jmes
秕	jmff
釉	jmid
剁	jmj
利	jmj
秃	jmj
稻	jmje
稗	jmji
彩	jmjj
穆	jmjj
稃	jmjk
梨	jmjm
透	jmjq
犁	jmjr
秩	jmjv
秀	jmjw
颓	jmjy
乘	jmkf
秤	jmki
剩	jmkj
秣	jmkm
秆	jmkr
穗	jmku
稂	jmla
科	jmlr
秫	jmml
稼	jmnc
租	jmnk
稠	jmno
秧	jmnv
和	jmo
程	jmoe
种	jmoi
稆	jmoo
积	jmoy
秸	jmro
穑	jmro
稹	jmry
黎	jmsi
秭	jmsi
移	jmss
稳	jmsu
称	jmsw
黧	jmsw
稚	jmtg
稽	jmvb
嵇	jmve
秘	jmwf
秒	jmwj
季	jmwk
稍	jmwn
悉	jmwu
委	jmx
魏	jmxc
稀	jmxe
逶	jmxq
税	jmyb
黍	jmyi
黏	jmyo
愁	jmyu
稔	jmyu
秋	jmyy
穰	jmza
稿	jmzo
释	jmzr
觅	jnb
血	jnh
衄	jnhg
衅	jnhr
舜	jnsi
爱	jnvz
奥	jnyv
受	jnz
丘	jo
岳	joe
乒	joj
乓	jol
禹	jonc
邱	jop
兵	joy
追	jpuq
阜	jpur
及	jq
千	jr
丢	jrc
牺	jrcc
犍	jreq
歃	jrey
盾	jrf
牝	jrf
我	jrfl
遁	jrfq
牡	jrg
特	jrgl
牦	jrjf
牲	jrjg
牿	jrjo
壬	jrk
乖	jrkf
廷	jrkq
犏	jrlh
虢	jrlj
长	jrll
犋	jrny
质	jrny
舌	jro
刮	jroj
甜	jrok
鹅	jroq
鸹	jroq
适	jroq
辞	jror
敌	jros
乱	jrou
憩	jrou
舐	jrou
舔	jrow
迁	jrq
牛	jrr
牯	jrro
犊	jrrv
牧	jrs
物	jrsj
牾	jrto
犄	jrvo
犒	jrzo
反	js
返	jsq
彳	jt
斤	jt
御	jtap
得	jtbl
徊	jtdo
很	jtea
律	jter
彻	jtfd
待	jtgl
街	jtgt
徒	jtgv
徘	jtii
衍	jtit
愆	jtiu
徨	jtje
徭	jtje
循	jtjf
徼	jtjs
役	jtjz
徕	jtkm
行	jtkt
惩	jtku
征	jtkv
斥	jtl
往	jtle
徂	jtnk
彼	jtpz
近	jtq
衔	jtqt
德	jtru
徇	jtsb
衡	jtst
欣	jtsy
衙	jttt
颀	jtty
徙	jtvv
徜	jtwo
後	jtws
徐	jtym
徉	jtyt
爰	jtz
彷	jtzd
径	jtzh
儿	ju
凸	ju
所	jujt
夭	jv
岙	jve
看	jvf
乔	jvji
延	jvq
拜	jvt
失	jvv
迭	jvvq
掰	jvyr
搿	jvyr
乃	jw
鼐	jwfk
孚	jwk
郛	jwkp
乳	jwku
奚	jwv
尕	jww
系	jww
孕	jwwk
盈	jwzh
戤	jwzl
风	jx
妥	jx
飕	jxez
飓	jxny
飑	jxsu
飚	jxyy
小	jy
凤	jz
殳	jz
一	k
兀	kb
虺	kbc
惠	kbgu
亘	kbk
墼	kbkg
軎	kbro
更	kbx
云	kc
魂	kcjc
动	kcpp
运	kcq
万	kd
虿	kdc
盛	kdfh
成	kdfl
趸	kdov
迈	kdq
画	kdu
屯	ke
顿	kety
北	kf
冀	kfdy
尧	kfkb
翘	kfkd
戈	kfl
划	kflj
背	kfn
邶	kfp
王	kg
贰	kgnl
开	kh
戒	khfl
平	khi
刑	khj
型	khjg
形	khjj
甙	khkl
邢	khp
牒	khqm
式	khul
夹	khy
郏	khyp
颊	khyy
下	ki
晋	kiib
垩	kiig
亚	kiik
戬	kiil
严	kiis
恶	kiiu
求	kil
裘	kila
逑	kilq
救	kils
丐	kis
忑	kiwu
厂	kj
牌	kjbi
豕	kjc
逐	kjcq
燹	kjcy
版	kjs
二	kk
臧	kkcl
戕	kkfl
末	kkw
牖	klpi
未	km
嫠	kmsx
再	kng
甫	kni
逋	kniq
敷	knis
丽	knll
郦	knlp
逦	knlq
鹂	knoq
刺	knwj
枣	knwl
棘	knww
丙	kny
邴	knyp
两	knyy
石	ko
砷	kobi
碍	kobl
碣	kobq
硒	kocc
砸	koce
砑	koci
碜	kocj
砥	kocl
砾	kocw
副	kodj
逼	kodq
碌	koei
事	koej
础	koeu
碳	koey
砌	kofd
砒	koff
硅	kogg
碡	kogr
碛	kogy
豆	koh
硭	kohc
礞	kohc
豇	kohh
碰	kohk
礴	kohl
碟	kohm
豌	kohp
逗	kohq
礤	kohw
磁	kohw
砹	kohx
磺	kohy
豉	kohz
泵	koi
磲	koim
砧	koio
矶	koj
碑	koji
矾	kojl
硪	kojl
斫	kojt
砜	kojx
硇	kojx
砭	kojz
硗	kokb
砘	koke
研	kokh
砰	koki
硎	kokj
礓	kokk
或	kokl
磊	koko
矸	kokr
惑	koku
硬	kokx
硖	koky
碥	kolh
矿	kols
硫	kolu
碴	komk
砚	konb
融	konc
翮	kond
砣	konf
鬲	koni
碹	konk
硼	konn
碉	kono
硐	kono
碗	konp
碇	konv
碘	kony
碾	kopa
破	kopz
砝	korc
磕	korh
矽	kos
砺	kosd
碱	kosl
磔	kosm
确	kosn
硌	koso
砍	kosy
碓	kotg
码	kots
礁	kotw
硕	koty
砖	kovd
砗	kovr
束	kow
砩	kowi
砀	kowj
剌	kowj
砂	kowj
硝	kown
速	kowq
敕	kows
整	kowv
赖	kowy
吏	kox
磴	koxh
磋	koyh
砼	koyh
磷	koyi
硷	koyk
砟	koyk
柬	koyw
砬	koz
磙	koza
磅	kozd
碲	koze
磉	kozm
碚	kozo
碎	kozr
礅	kozs
干	kr
于	kr
刊	krj
壮	krk
装	krka
奘	krkv
盂	krnh
邗	krp
迂	krq
顸	krty
牍	krzv
歹	ks
殆	ksco
死	ksf
残	ksgl
浆	ksi
列	ksj
裂	ksja
殍	ksjk
歼	ksjr
烈	ksjw
殁	ksjz
桨	ksm
殂	ksnk
殃	ksnv
殡	ksny
殒	ksoy
殪	ksrh
殖	ksrk
将	ksrl
殉	kssb
酱	ksu
奖	ksv
殛	kswk
餮	ksya
殇	ksyj
殄	ksyj
殓	ksyk
殊	ksym
殚	ksyr
亍	kt
七	ku
弋	kul
鸢	kuoq
天	kv
正	kv
蚕	kvc
戎	kvfl
状	kvl
吞	kvo
政	kvs
鄢	kvsp
焉	kvsw
忝	kvw
不	kw
丕	kwk
邳	kwkp
歪	kwkv
甭	kwn
否	kwo
还	kwq
忒	kwul
孬	kwxk
夷	kwy
丈	kx
妆	kx
祚	kyk
来	kym
赉	kymy
灭	kyy
言	l
谩	lbfz
课	lbm
谒	lbsq
亡	lc
充	lcb
谮	lcbb
谭	lccr
诓	lce
盲	lcf
弃	lch
讶	lci
诋	lckl
肓	lcn
育	lcn
望	lcne
诒	lco
羸	lcol
蠃	lcol
嬴	lcol
赢	lcol
邙	lcp
氓	lcpu
讵	lcu
忘	lcwu
讴	lcx
妄	lcx
诶	lcyv
诩	lddd
谬	lddj
词	ldko
诵	ldn
谓	ldn
诏	ldo
谘	ldso
永	ldx
昶	ldxb
谡	ldys
谲	ldzo
讪	le
主	le
良	lea
朗	lecn
郎	lecp
谀	leey
诎	leu
诣	lfb
谐	lffb
谢	lfjl
诹	lfrz
诖	lgg
诸	lgjb
请	lgn
讳	lgp
诗	lgrl
讧	lh
谟	lhbv
谌	lhcy
谦	lhei
谱	lhib
谋	lhkm
谎	lhlu
谫	lhnd
谨	lhog
谍	lhqm
诺	lhvo
谥	lhyh
诬	lhyy
讣	li
诽	lii
让	lik
讥	lj
谣	ljae
诜	ljgb
诰	ljgo
训	ljii
诟	ljko
诱	ljmw
诿	ljmx
话	ljro
诉	ljtl
谖	ljtz
诞	ljvq
讽	ljx
设	ljz
诚	lkdl
评	lkhi
诫	lkhl
试	lkhl
诼	lkjc
谏	lkow
讦	lkr
证	lkv
谰	llnw
谝	llph
斗	llr
头	llv
门	ln
间	lnb
阊	lnbb
闽	lnc
阍	lncb
闸	lndi
阃	lndm
闰	lne
阋	lneb
阒	lnfl
闻	lnfr
闺	lngg
闫	lngk
调	lngo
闱	lngp
阙	lnhy
阔	lnio
诧	lnjf
阌	lnjz
闩	lnk
诅	lnk
阈	lnkl
阑	lnkw
阆	lnla
闲	lnm
谊	lnnk
问	lno
闾	lnoo
鹇	lnoq
阖	lnrh
闭	lnrj
阗	lnry
阎	lnse
阁	lnso
阄	lnsu
阀	lntl
闯	lnts
阚	lnts
闳	lnvc
闼	lnvq
诨	lnvr
阉	lnvu
闷	lnwu
阕	lnxv
讷	lny
闪	lny
阅	lnyb
阐	lnyr
闹	lnze
闶	lnzj
阏	lnzl
闵	lnzx
阂	lnzy
谴	logq
误	lokv
谔	loos
识	loy
户	lp
扇	lpdd
谑	lpfe
扉	lpii
戽	lplr
肩	lpn
翩	lpnd
扁	lpnh
扃	lpno
遍	lpnq
启	lpo
扈	lpou
为	lppl
肇	lpsr
綮	lpsw
雇	lptg
戾	lpvl
房	lpzd
计	lr
诘	lrko
讨	lrl
谳	lrnl
诂	lro
诔	lry
读	lrzv
广	ls
询	lsb
廛	lsbg
底	lscl
廖	lsdj
序	lsdj
诌	lse
谄	lsee
康	lsei
庸	lsei
诤	lsej
唐	lseo
庚	lsey
赓	lsey
庾	lsey
庀	lsf
庇	lsff
庄	lsg
廒	lsgs
席	lshe
廑	lshg
廉	lshi
庹	lshl
遮	lshq
庶	lshw
度	lshz
庙	lsid
店	lsio
庳	lsji
庭	lsjq
廊	lslp
庐	lslp
床	lsm
麽	lsmc
魔	lsmc
麾	lsmf
靡	lsmi
麻	lsmm
糜	lsmm
磨	lsmo
摩	lsmr
縻	lsmw
谗	lsol
鹰	lsoq
鹧	lsoq
邝	lsp
庋	lsrz
谵	lssl
诡	lssp
廨	lssr
庖	lssu
府	lstl
庥	lstm
膺	lstn
庑	lstu
腐	lsty
麈	lsue
鹿	lsuf
麟	lsui
麂	lsuj
麝	lsul
麇	lsum
麋	lsum
鏖	lsuq
麒	lsuy
庆	lsv
庞	lsvl
库	lsvr
庵	lsvu
应	lswk
座	lsyg
庠	lsyt
廓	lszp
廪	lszw
订	lt
记	ltc
讹	ltf
语	ltho
诃	lto
诀	ltv
谁	ltzg
谯	ltzw
讲	lvi
诙	lvyy
谧	lwfh
诮	lwn
谠	lwnb
诳	lxje
议	lxl
认	ly
讼	lyc
诲	lydr
诠	lye
论	lyf
诊	lyjj
诈	lyk
谕	lykj
谂	lylu
诛	lym
谜	lymq
说	lyob
许	lyr
详	lyt
谶	lyyl
谈	lyyy
讫	lyz
之	lz
谙	lzb
访	lzd
谛	lze
谚	lzjj
讯	lzr
谪	lzro
译	lzrr
该	lzuy
谅	lzw
谆	lzwk
谇	lzyr
谤	lzzd
木	m
杳	mb
榻	mbdd
棍	mbff
查	mbk
棵	mbm
桃	mbx
栖	mcc
榴	mcdd
框	mce
桎	mcg
椽	mchc
榧	mcii
柳	mcjp
柢	mckl
柩	mcsl
柜	mcu
栎	mcw
枢	mcx
梭	mcys
栩	mddd
柙	mdi
楣	mdjf
桶	mdn
杷	mdu
杼	mdzj
橘	mdzo
懋	mdzu
枉	me
根	mea
概	mecb
桕	mee
棣	mei
楗	merq
桤	metc
棂	meyy
相	mf
枇	mff
楷	mffb
榭	mfjl
椴	mfkz
椰	mfrp
椤	mfs
想	mfwu
楞	mfzd
杜	mg
栈	mgfl
桂	mgg
楮	mgjb
栳	mgjf
栲	mgjs
樾	mgvl
标	mgw
柰	mgw
棱	mgys
杠	mh
槽	mhbb
模	mhbv
椹	mhcy
栏	mhg
柑	mhk
棋	mhky
檬	mhnc
槿	mhog
栉	mhp
朴	mi
棹	mibr
柚	mid
榄	miib
槛	miih
椒	mikz
桢	miny
栌	mip
桫	miwj
机	mj
柏	mjb
槐	mjbc
棉	mjbe
槔	mjbk
檄	mjbs
梏	mjgo
杉	mjjj
橇	mjkf
棰	mjkg
栀	mjkp
楸	mjmy
槌	mjpq
极	mjq
枨	mjrl
栝	mjro
梃	mjrq
板	mjs
析	mjt
皙	mjtb
柝	mjtl
桁	mjtt
桥	mjvi
楹	mjwh
桴	mjwk
枫	mjx
本	mk
杌	mkb
桓	mkbk
梗	mkbx
桡	mkfb
枰	mkhi
械	mkhl
桠	mkik
柄	mkny
柘	mko
楝	mkow
杆	mkr
朽	mks
杯	mkw
术	ml
梳	mlcu
柱	mle
榔	mlep
槠	mlgb
榈	mlno
述	mlq
桩	mlsg
林	mm
楂	mmbk
禁	mmgw
彬	mmjj
梵	mmjl
麓	mmlf
森	mmm
郴	mmp
梦	mms
婪	mmx
棼	mmyd
焚	mmyy
楚	mmzv
枧	mnb
枕	mnb
柁	mnf
棕	mngw
槟	mnjy
楦	mnkk
桐	mnko
棚	mnn
栅	mnnk
棺	mnpu
柠	mnt
榷	mntg
桉	mnx
檫	mnxw
枘	mny
榨	mnyk
榕	mnyo
樱	mnyx
杏	mo
楫	mofr
枵	moks
榀	mooo
枳	moy
樨	mpir
枷	mppo
椐	mprd
椭	mpvn
榍	mpwn
楔	mrdv
樯	mrho
材	mrj
桔	mrko
村	mrl
植	mrnk
楠	mrnr
枯	mro
枝	mrz
椟	mrzv
枚	ms
构	msc
橹	msdb
橛	mshy
槭	msil
橱	mskl
杓	msl
桷	msn
槲	msnr
枸	mso
橡	msoc
枥	mspp
格	msqo
檐	mssl
桅	mssp
杞	mtc
桦	mtfr
橄	mtfs
梧	mtho
柯	mto
杩	mts
檑	mtxd
樗	mtxs
椎	mtzg
榫	mtzr
樵	mtzw
札	mu
椿	mvb
栊	mvfl
榛	mvjm
楱	mvkv
梆	mvp
棒	mvrr
椅	mvto
栋	mvw
杰	mw
橼	mwcc
档	mwe
杪	mwj
杨	mwjj
李	mwk
桄	mwkb
榉	mwkr
梢	mwn
樘	mwng
橙	mxkh
攀	mxxr
樊	mxxv
松	myc
梅	mydr
栓	mye
柞	myk
桧	mykc
榆	mykj
检	mykk
柃	myld
株	mym
楼	mymx
枪	myp
杵	myr
样	myt
槎	myth
樽	myul
梯	mywi
枞	myy
檎	myzc
权	mz
樟	mzbr
枋	mzd
檀	mzdk
檩	mzdw
柿	mze
柽	mzg
杭	mzj
榱	mzka
杈	mzl
榇	mzm
槁	mzno
梓	mzr
树	mzrl
腋	mzts
核	mzuy
椋	mzw
椁	mzwk
校	mzyx
榜	mzzd
月	n
农	na
见	nb
审	nbi
胂	nbi
腥	nbjg
胆	nbk
寓	nbnc
腽	nbnh
鸩	nboq
幂	nbve
宴	nbx
冥	nbzy
县	nc
膘	nccw
腰	nccx
室	ncg
胝	nckl
胎	nco
悬	ncwu
宦	ncy
寥	nddj
胛	ndi
肥	ndu
胭	ndv
腮	ndwu
腿	neaq
腴	neey
薇	nekj
宝	nel
腱	nerq
它	nf
脂	nfb
寰	nfka
肚	ng
冉	ng
朊	ngb
完	ngb
冠	ngbl
寇	ngbz
冒	ngf
勖	ngfp
腈	ngn
周	ngo
雕	ngog
肟	ngs
冕	ngsb
宗	ngw
肛	nh
皿	nh
腊	nhb
膜	nhbv
寞	nhbv
胼	nhh
罔	nhlc
宽	nhnb
朦	nhnc
胖	nhr
骞	nhts
腾	nhts
朕	nhv
塍	nhvg
滕	nhvi
媵	nhvx
典	nhy
褰	nhya
塞	nhyg
寒	nhyl
謇	nhyl
寨	nhym
搴	nhyr
蹇	nhyv
赛	nhyy
用	ni
宙	nid
腓	nii
胩	niki
寂	nikz
胪	nip
肌	nj
冗	nj
刖	nj
脾	njbi
腺	njbi
胍	njcl
宅	njf
胜	njg
宪	njgb
肜	njjj
宾	njoy
胀	njrl
牢	njrr
脬	njwk
股	njz
且	nk
宣	nkbk
肺	nke
徵	nke
肫	nke
寝	nkez
腻	nkgl
微	nkj
家	nkjc
豚	nkjc
冢	nkjc
寐	nkkm
脯	nkni
膊	nknl
宕	nko
同	nko
富	nkod
膈	nkoi
璺	nkol
爨	nkoy
助	nkpp
肝	nkr
宇	nkr
雎	nktg
寤	nkto
定	nkv
胚	nkwk
徽	nkww
胰	nkwy
杖	nkx
具	nky
脉	nldx
实	nllv
脏	nlsg
臁	nlsi
腑	nlsl
宋	nm
髓	nmvq
骨	nn
朋	nn
脓	nna
髁	nnbm
骶	nncl
髑	nnfc
脘	nngb
腙	nngw
腆	nnhy
髀	nnji
骺	nnjo
膑	nnjy
骰	nnjz
册	nnk
宜	nnk
删	nnkj
胴	nnko
腚	nnkv
髋	nnnb
髂	nnno
髌	nnny
鹘	nnoq
鹏	nnoq
骷	nnro
骼	nnso
腕	nnsp
胺	nnx
肭	nny
膣	nnyg
腔	nnyh
骱	nnyi
髅	nnyx
骸	nnzy
向	no
肿	noi
脶	nony
宫	noo
臊	noom
腭	noos
迥	noq
脲	npi
肋	npp
胁	nppy
官	npu
逭	npuq
服	npz
丹	nr
舟	nr
舾	nrcc
脚	nrcp
舢	nre
艘	nrez
舭	nrff
舡	nrh
艚	nrhb
艨	nrhc
舳	nrid
舻	nrip
舶	nrjb
船	nrjo
磐	nrjo
艇	nrjq
舨	nrjs
般	nrjz
膨	nrkj
臌	nrkz
守	nrl
肘	nrl
舰	nrnb
舵	nrnf
盘	nrnh
脖	nrnk
腩	nrnr
害	nro
舯	nroi
割	nroj
豁	nroo
艉	nrpf
舸	nrto
艋	nrwh
艄	nrwn
舣	nrxl
艏	nryf
舴	nryk
舱	nryp
肢	nrz
舫	nrzd
艟	nrzg
航	nrzj
舷	nrzw
写	nsk
宸	nska
朐	nso
冤	nsol
宛	nsp
剜	nspj
胳	nsqo
客	nsqo
额	nsqy
脆	nssp
胞	nsuu
胸	nsxu
肷	nsy
宁	nt
腼	ntdo
寅	ntdy
寡	ntfd
鹤	ntoq
宿	nttb
宄	nu
甩	nu
央	nv
腌	nvbu
肱	nvc
宏	nvc
宠	nvfl
胧	nvfl
胯	nvgs
肼	nvi
腠	nvkv
肽	nvl
宥	nvn
盎	nvnh
鸯	nvoq
军	nvr
郓	nvrp
皲	nvrz
寄	nvto
肤	nvv
胨	nvw
膝	nvyi
宓	nwf
蜜	nwfc
密	nwfe
肠	nwjj
字	nwk
胱	nwkb
宵	nwn
膛	nwng
甯	nwun
安	nx
冈	nx
察	nxgw
刚	nxj
案	nxm
脎	nxm
网	nxx
贝	ny
内	ny
穴	ny
窑	nyae
赐	nybj
窠	nybm
腹	nybs
窕	nybx
窒	nycg
穿	nyci
贻	nyco
帘	nye
窘	nyeo
窃	nyfd
赌	nygb
赋	nygl
贱	nygl
空	nyh
赚	nyhi
邃	nyhq
窍	nyhs
贴	nyio
则	nyj
胗	nyjj
窳	nyjl
账	nyjl
窖	nyjo
窗	nyjs
贩	nyjs
贬	nyjz
窆	nyjz
胙	nyk
脍	nykc
窀	nyke
腧	nykj
脸	nykk
赙	nykl
赇	nykl
贼	nykl
罕	nykr
赃	nylg
脒	nym
膦	nymi
罂	nyne
贮	nynk
婴	nynx
贶	nyob
脱	nyob
窜	nyoi
鹦	nyoq
窝	nyoy
窿	nypg
赆	nypl
穷	nypp
窟	nypu
财	nyrj
窦	nyrv
赎	nyrv
败	nys
穸	nys
赈	nysa
购	nysc
赡	nysl
赂	nyso
膳	nyto
究	nyu
窥	nyvb
突	nyvl
贿	nyvn
穹	nyw
窈	nywp
肉	nyy
灾	nyy
赠	nyyb
脞	nyyg
窬	nyyj
窄	nyyk
容	nyyo
赊	nyyw
窭	nyyx
赕	nyyy
窨	nyzb
赔	nyzo
赅	nyzy
臆	nzbu
肪	nzd
膻	nzdk
膪	nzeo
胫	nzh
肮	nzj
彤	nzjj
宰	nzr
胲	nzuy
臃	nzwg
脐	nzxi
脑	nzxu
胶	nzyx
膀	nzzd
口	o
噬	oaah
兄	ob
唱	obb
嘬	obfz
哩	obg
呻	obi
喁	obnc
喝	obsq
黾	obu
虽	oc
吮	ocb
哂	occ
嘌	occw
哐	oce
咂	oce
喙	ochc
呀	oci
哞	ocjr
呕	ocx
唆	ocys
唉	ocyv
叨	od
喂	oda
呷	odi
叼	odk
喟	odn
嗵	odnq
吧	odu
邑	odu
咽	odv
哪	odvp
嗯	odvu
呈	oe
吊	oe
哏	oea
唧	oecp
嗖	oeez
嗤	oekc
喘	oeki
嘣	oenn
郢	oep
逞	oeq
哕	oes
咄	oeu
啸	oewi
叱	of
吡	off
喈	offb
哔	offr
嘎	ofl
戢	ofrl
嗫	ofrz
吐	og
嗷	ogds
哇	ogg
哧	ogii
嗜	ogjb
哮	ogjk
嘟	ogjp
遗	ognq
贵	ogny
啧	ogny
遣	ogpq
唛	ogs
嗉	ogww
嘈	ohbb
噶	ohbq
喵	ohd
嗍	ohen
嘶	ohkt
唠	ohnp
嘞	ohop
喋	ohqm
嗬	ohto
喏	ohvo
哎	ohx
哄	ohy
嗌	ohyh
嗒	ohyo
呓	ohz
嚆	ohzo
卟	oi
中	oi
啡	oii
噗	oiiv
咔	oiki
盅	oinh
啵	oipz
忠	oiwu
嗨	oiyr
叽	oj
哌	oja
唣	ojbf
啤	ojbi
嗥	ojbk
呱	ojcl
咱	ojf
吒	ojf
嚼	ojfl
嗅	ojfl
呼	ojhj
唾	ojkg
哚	ojm
啾	ojmy
噢	ojnv
嗳	ojnz
吸	ojq
哦	ojrl
听	ojt
哽	okbx
吨	oke
哓	okfb
吓	oki
哑	okik
啄	okjc
味	okm
哺	okni
嗝	okoi
喇	okoj
嗽	okoy
吁	okr
号	oks
饕	oksa
咧	oksj
吴	okv
呸	okwk
咦	okwy
唁	ol
唷	olcn
咏	oldx
啷	olep
唳	olpl
嘛	olsm
呆	om
喳	ombk
啉	omm
噤	ommw
哝	ona
啁	ongo
噻	onhg
嗣	onho
咤	onjf
咀	onk
喧	onkk
啶	onkv
响	ono
鹃	onoq
喀	onso
咛	ont
嘧	onwe
嚓	onxw
呗	ony
呙	ony
呐	ony
员	ony
剐	onyj
勋	onyp
郧	onyp
嘤	onyx
吕	oo
鼍	oodu
鄂	oogp
颚	oogy
串	ooi
患	ooiu
咒	ooj
品	ooo
噪	ooom
鹗	oooq
鸣	ooq
嚣	ooto
骂	oots
哭	oovl
器	oovo
嘿	ooyw
叩	op
喔	opcg
唰	opej
呢	opf
噱	opfc
唬	opfj
嘘	opfk
嘱	opjc
噼	opor
叻	opp
另	opp
别	oppj
咖	oppo
啊	opto
鸟	oq
袅	oqa
岛	oqe
鹱	oqhz
凫	oqj
枭	oqm
鸵	oqnf
叶	or
嘲	orbn
嗑	orch
鄙	ordp
喷	orhy
啪	orjb
哳	orjt
噎	orkh
嘭	orkj
咭	orko
嘻	orko
喃	ornr
嚏	ornv
嗦	ornw
嗔	orny
咕	oro
囔	oroa
啦	orz
吱	orz
啕	osae
喱	osbg
噜	osdb
噘	oshy
嘁	osil
吻	osjj
唿	osju
喊	oskl
唤	osnv
呃	osp
呖	ospp
咚	osql
咯	osqo
哆	oss
呜	ossk
咆	osuu
吹	osy
叮	ot
咿	otej
哗	otfr
嗄	otfs
唔	otho
喉	othv
咻	otm
呵	oto
咐	otrl
吗	ots
呒	otu
嚯	otxg
嚅	otxi
唯	otzg
噍	otzw
叫	ou
足	ov
蹋	ovbd
踢	ovbj
踝	ovbm
跳	ovbx
跆	ovco
距	ovcu
躐	ovcu
跞	ovcw
蹂	ovdm
踊	ovdn
跟	ovea
踹	ovei
蹦	oven
踺	oveq
呲	ovf
躅	ovfc
咙	ovfl
嘴	ovfn
跸	ovfr
蹑	ovfz
喹	ovgg
跬	ovgg
践	ovgl
躇	ovhb
躏	ovhg
蹀	ovhm
踯	ovhp
蹒	ovhy
踏	ovib
踔	ovir
蹼	oviv
跣	ovjb
踽	ovjc
蹯	ovjd
蹈	ovje
踵	ovjg
踩	ovjm
跺	ovjm
嗪	ovjm
趿	ovjq
跹	ovjq
跌	ovjv
蹊	ovjv
跃	ovjv
踬	ovjy
躜	ovjy
跷	ovkb
趼	ovkh
跖	ovko
吠	ovl
呔	ovl
踉	ovla
躔	ovlg
蹁	ovlh
踮	ovlo
踱	ovlz
啃	ovn
跎	ovnf
蹿	ovni
跚	ovnk
踪	ovnw
躁	ovom
鹭	ovoq
跏	ovpo
踞	ovpo
跛	ovpz
哒	ovq
啭	ovrd
唪	ovrr
趵	ovsl
蹰	ovsl
路	ovso
跪	ovsp
跑	ovsu
蹶	ovsy
跗	ovtl
跽	ovtu
呋	ovv
趾	ovv
跋	ovvl
踌	ovvl
跨	ovvs
趺	ovvv
蹬	ovxh
趴	ovy
蹭	ovyb
蹉	ovyh
蹲	ovyl
踟	ovyo
跄	ovyp
啮	ovyu
嘹	ovyw
咴	ovyy
躞	ovyz
蹄	ovze
跻	ovzi
蹴	ovzl
踣	ovzo
跤	ovzx
吆	ow
吲	owi
吵	owj
咣	owkb
吼	owku
哨	own
唢	owny
呦	owpp
哟	owsl
吣	owu
咝	owwk
史	ox
噔	oxkh
唏	oxve
呶	oxz
叭	oy
只	oy
嗡	oycd
吩	oyd
噌	oydb
黯	oygb
墨	oygg
黪	oygj
默	oygl
黠	oygo
黝	oygp
黢	oygs
黟	oygs
黜	oygu
黩	oygv
黑	oygw
黥	oygw
黔	oygz
吖	oyi
咋	oyk
哙	oykc
喻	oykj
哈	oyko
啥	oyko
呤	oyld
吟	oylz
咪	oym
喽	oymx
呛	oyp
咩	oyt
嗟	oyth
嗲	oyxs
唑	oyyg
啖	oyyy
吃	oyz
噙	oyzc
叹	oz
喑	ozb
噫	ozbu
嗾	ozdv
啼	oze
吭	ozj
嚎	oznc
嚷	ozoa
嘀	ozro
咳	ozuy
哼	ozw
唼	ozx
哜	ozxi
啐	ozyr
咬	ozyx
嗓	ozzm
啜	ozzz
尸	p
阳	pb
陧	pbg
疸	pbk
隅	pbnc
瘟	pbnh
隰	pbww
瘭	pccw
瘤	pcdd
屋	pcg
隈	pda
瘳	pddj
痛	pdn
局	pdo
痼	pdro
痹	pdti
疤	pdu
瘰	pdww
疟	pe
疝	pe
痕	pea
限	pea
瘐	peey
瘦	peez
刷	pej
屈	peu
癍	peze
尼	pf
虐	pfe
屁	pff
陛	pffg
觑	pfib
虚	pfik
虎	pfj
彪	pfjj
遽	pfkq
虞	pfov
虏	pfpp
陬	pfrz
虑	pfwu
虔	pfzx
阮	pgb
屠	pgjb
痔	pgrl
陡	pgv
际	pgw
尉	pgwl
慰	pgwu
熨	pgwy
陵	pgys
展	pha
瘼	phbv
屏	phh
癀	phiy
隧	phjq
疳	phk
痨	phnp
屉	phq
隘	phyh
臀	phyn
瘩	phyo
殿	phyz
尿	pi
届	pid
瘊	pihv
痱	pii
犀	pijr
阽	pio
痧	piwj
隗	pjbc
隍	pjbe
陴	pjbi
瘪	pjff
尾	pjkf
陲	pjkg
痢	pjmj
痿	pjmx
属	pjoc
阡	pjr
阪	pjs
履	pjts
屣	pjtv
屦	pjtx
屐	pjtz
疯	pjx
疫	pjz
卫	pk
阢	pkb
层	pkc
疠	pkd
瘗	pkhg
陕	pkhy
痖	pkik
瘃	pkjc
遐	pkkq
陋	pknq
病	pkny
痘	pkoh
隔	pkoi
瘌	pkoj
癞	pkoy
民	pku
愍	pkuu
症	pkv
痞	pkwo
痍	pkwy
疰	ple
尺	pll
昼	pllk
尽	plll
咫	plly
痫	plnm
迟	plq
阴	pn
痈	pn
陀	pnf
院	pngb
疽	pnk
阻	pnk
瘢	pnrz
瘿	pnyx
陨	pony
癌	pooe
襞	poza
劈	pozd
壁	pozg
璧	pozl
甓	pozl
譬	pozl
檗	pozm
臂	pozn
鐾	pozq
避	pozq
擘	pozr
辟	pozr
嬖	pozx
疖	pp
力	pp
瘕	ppgz
癜	pphz
加	ppo
袈	ppoa
架	ppom
哿	ppoo
迦	ppoq
癖	ppor
贺	ppoy
痂	pppo
勰	pppu
瘸	pppy
边	ppq
癃	ppsg
瘾	ppsu
屙	ppto
驾	ppts
办	ppy
陂	ppz
疲	ppz
瘛	prdu
痣	prku
癫	prny
居	pro
剧	proj
陆	prru
陶	psae
癣	psdt
陷	psee
隐	pseu
疚	psll
痪	psnv
疬	pspp
隆	psqg
降	psqi
疼	psql
疱	psuu
疔	pt
陌	ptb
痦	ptho
阿	pto
疴	pto
附	ptrl
尻	pu
也	pu
疵	pvf
陇	pvfl
隋	pvhn
阱	pvi
陟	pvij
堕	pvng
随	pvnq
隳	pvnw
阵	pvr
骘	pvts
疣	pvul
陈	pvw
废	pvzl
疗	pw
隙	pwbw
疡	pwjj
孱	pwkk
屑	pwn
瘵	pxgw
队	py
瘅	pybr
痊	pye
坠	pyg
阶	pyji
疥	pyji
疹	pyjj
痄	pyk
阼	pyk
险	pykk
除	pykm
屎	pym
瘘	pymx
屡	pymx
疮	pyp
痒	pyt
瘥	pyth
羼	pytt
疾	pyv
痴	pyvo
瘠	pyxn
痤	pyyg
痰	pyyy
疙	pyz
皮	pz
障	pzbr
瘴	pzbr
癔	pzbu
防	pzd
瘀	pzdl
陉	pzh
痉	pzh
瘙	pzlc
陪	pzo
瘫	pztg
颇	pzty
陔	pzuy
痃	pzw
瘁	pzyr
金	q
铱	qa
锟	qbff
镘	qbfz
锂	qbg
钽	qbk
锝	qbkl
锞	qbm
锡	qbsj
铫	qbx
锱	qccd
镡	qccr
镖	qccw
镏	qcdd
铘	qcip
铆	qcjp
钷	qco
钜	qcu
铄	qcw
钺	qcxl
钿	qd
钾	qdi
镅	qdjf
锢	qdro
钯	qdu
铟	qdv
锶	qdwu
镙	qdww
银	qea
锼	qeez
钰	qel
锓	qenz
键	qerq
铠	qetc
钼	qf
锴	qffb
锻	qfkz
铒	qfr
镊	qfrz
锣	qfs
镯	qfsc
钍	qg
钱	qgfl
锗	qgjb
铑	qgjf
铐	qgjs
锖	qgn
错	qhb
镆	qhbv
锚	qhd
镨	qhib
钳	qhk
铹	qhnp
镬	qhtz
锘	qhvo
锩	qhvp
镒	qhyh
钋	qi
铀	qid
铿	qiig
镤	qiiv
钻	qio
铴	qiwj
镌	qizw
钊	qj
铂	qjb
锦	qjbe
镍	qjfm
铣	qjgb
锆	qjgo
钏	qjii
钐	qjjj
锤	qjkg
锺	qjkg
钒	qjl
绣	qjmw
锈	qjmw
锹	qjmy
铅	qjo
钎	qjr
铥	qjrc
锸	qjre
锇	qjrl
锊	qjrl
铤	qjrq
钣	qjs
锨	qjty
锾	qjtz
铁	qjvv
铖	qkdl
钝	qke
铙	qkfb
铗	qkhy
钙	qkis
铺	qkni
镉	qkoi
锵	qksl
钲	qkv
钚	qkw
铽	qkwl
铼	qkym
铳	qlcb
锍	qlcu
锒	qlea
钭	qllr
钔	qln
锏	qlnb
锎	qlnh
镧	qlnw
镰	qlsi
镛	qlsi
镳	qlsw
镀	qlsz
钵	qmk
钥	qn
铊	qnf
镔	qnjy
镓	qnkc
铜	qnko
锄	qnkp
锭	qnkv
铵	qnx
钢	qnx
镲	qnxw
钡	qny
钠	qny
镩	qnyi
铡	qnyj
铞	qoe
锃	qoe
钟	qoi
锅	qony
铝	qoo
锷	qoos
锔	qpdo
铌	qpf
锯	qpro
锕	qpto
铍	qpz
鑫	qqq
针	qr
锲	qrdv
镇	qrny
钴	qro
钩	qsc
钧	qsd
镥	qsdb
铯	qsdu
铮	qsej
镢	qshy
锪	qsju
钓	qsl
铭	qso
铬	qsqo
锋	qsqr
钨	qssk
钦	qsy
钉	qt
铧	qtfr
钮	qtg
钶	qto
镭	qtxd
锥	qtzg
钆	qu
钸	qve
钛	qvl
铕	qvn
锛	qvrh
铸	qvrl
链	qvrq
镣	qvyw
钹	qvzl
钌	qw
铛	qwe
铋	qwf
钞	qwj
镄	qwjy
锰	qwkh
销	qwn
镗	qwng
锁	qwny
镪	qwoc
钕	qx
镫	qxkh
铩	qxm
铷	qxo
铨	qye
镁	qyev
铪	qyko
镎	qykr
铃	qyld
钤	qylz
铢	qym
镂	qymx
锐	qyob
锑	qywi
钬	qyy
锉	qyyg
锬	qyyy
钇	qz
锿	qza
镜	qzbb
镱	qzbu
钫	qzd
镟	qzdv
镞	qzdv
铈	qze
铲	qzj
钪	qzj
钗	qzl
镐	qzno
锫	qzo
镶	qzoa
锌	qzr
镝	qzro
铎	qzrr
铉	qzw
镦	qzws
铰	qzyx
镑	qzzd
十	r
攥	raaw
拽	rbf
撮	rbfz
捏	rbg
抻	rbi
担	rbk
捍	rbkr
提	rbkv
翰	rbrd
戟	rbrl
朝	rbrn
韩	rbrp
斡	rbrr
乾	rbrz
揭	rbsq
挑	rbx
去	rc
揠	rcbx
拶	rccs
拚	rch
掾	rchc
抵	rckl
拟	rcly
盍	rcnh
抬	rco
却	rcp
抑	rcp
劫	rcpp
拒	rcu
掺	rcvj
抠	rcx
挨	rcyv
摺	rddb
擢	rddg
掴	rdel
押	rdi
捆	rdm
捅	rdn
招	rdo
拇	rdr
挈	rdr
撂	rdso
把	rdu
契	rdv
挪	rdvp
摁	rdvu
恝	rdwu
摞	rdww
抒	rdzj
揉	rdzm
扫	re
搜	reez
捃	rejo
揣	reki
摧	retg
拙	reu
妻	rex
指	rfb
批	rff
揩	rffb
攫	rffz
擐	rfka
摆	rfrc
揶	rfrp
摄	rfrz
挂	rgg
拷	rgjs
持	rgrl
卉	rh
扛	rh
丧	rha
措	rhb
摸	rhbv
描	rhd
啬	rhdo
搛	rhei
搠	rhen
拦	rhg
拼	rhh
撕	rhkt
捞	rhnp
撒	rhns
贲	rhny
揲	rhqm
拌	rhr
掷	rhvp
拱	rhy
搽	rhym
搭	rhyo
扑	ri
掉	ribr
抽	rid
排	rii
揽	riib
拈	rio
才	rj
摇	rjae
拍	rjb
捭	rjbi
托	rjf
擤	rjfi
攒	rjgy
抓	rjil
撬	rjkf
捶	rjkg
播	rjmd
揪	rjmy
授	rjnz
搋	rjpj
扦	rjr
插	rjre
捋	rjrl
括	rjro
挺	rjrq
扳	rjs
折	rjt
蜇	rjtc
拆	rjtl
誓	rjtl
哲	rjto
逝	rjtq
掀	rjty
援	rjtz
挢	rjvi
扔	rjw
投	rjz
士	rk
馨	rkdb
罄	rkde
声	rkdj
謦	rkdl
磬	rkdo
捷	rkev
挠	rkfb
找	rkfl
款	rkgy
抨	rkhi
拭	rkhl
挟	rkhy
抹	rkkm
壹	rknh
捕	rkni
壳	rknj
壶	rknk
博	rknl
搏	rknl
悫	rknu
懿	rknu
彀	rknz
毂	rknz
觳	rknz
砉	rko
吉	rko
拓	rko
瞽	rkof
鼙	rkoi
彭	rkoj
甏	rkol
嘉	rkoo
喜	rkoo
熹	rkow
颉	rkoy
鼓	rkoz
掭	rkvw
志	rkwu
寸	rl
撤	rlcs
拄	rle
抖	rllr
扪	rln
搁	rlno
护	rlp
捩	rlpl
掮	rlpn
过	rlq
扩	rls
掂	rlso
搪	rlso
摭	rlsw
揸	rmbk
拥	rn
献	rnhl
南	rnhr
摈	rnjy
直	rnk
矗	rnkk
揎	rnkk
颠	rnky
真	rnky
鹁	rnoq
搬	rnrz
拧	rnt
挥	rnvr
孛	rnwk
勃	rnwp
索	rnww
按	rnx
擦	rnxw
控	rnyh
撺	rnyi
探	rnym
撄	rnyx
挖	rnyz
古	ro
扣	ro
克	rob
兢	robb
挹	rodu
揖	rofr
胡	ron
捐	ron
囊	rona
蠹	ronc
橐	ronm
损	rony
操	room
鸪	rooq
鹕	rooq
捌	ropj
拐	ropp
嘏	ropz
捣	roqe
掼	rory
故	ros
捉	rov
辜	rozr
握	rpcg
掘	rpeu
掳	rpfp
摅	rpfu
搌	rpha
摒	rphh
抿	rpku
擗	rpor
协	rppy
据	rpro
报	rpz
披	rpz
揿	rqsy
擀	rrbr
彗	rre
慧	rreu
拮	rrko
撷	rrky
挝	rrlq
攮	rroa
丰	rrr
击	rru
技	rrz
掏	rsae
撸	rsdb
艳	rsdu
掐	rsee
挣	rsej
捱	rsgg
撅	rshy
振	rska
撼	rsku
换	rsnv
拘	rso
挽	rsob
搀	rsol
扼	rsp
抱	rsuu
掬	rsym
打	rt
撖	rtfs
扭	rtg
捂	rtho
拊	rtrl
抚	rtu
抉	rtv
擂	rtxd
攉	rtxg
推	rtzg
携	rtzw
扎	ru
执	rul
蛰	rulc
垫	rulg
势	rulp
挚	rulr
热	rulw
絷	rulw
贽	ruly
鸷	ruoq
抛	rupp
撰	ruuy
扯	rv
掩	rvbu
抟	rvd
拢	rvfl
挎	rvgs
捺	rvgw
揍	rvkv
挞	rvq
捧	rvrr
掎	rvto
扶	rvv
扰	rvvl
撵	rvvr
拣	rvw
撩	rvyw
拔	rvzl
拨	rvzl
搦	rwdd
挡	rwe
抄	rwj
拂	rwji
扬	rwjj
捎	rwn
搅	rwnb
撑	rwnr
拗	rwpp
拯	rwxk
揆	rxkv
扒	ry
耒	ry
耦	rybc
掸	rybr
扮	ryd
耙	rydu
拴	rye
撇	ryes
抡	ryf
耩	ryhg
耢	ryhp
耗	ryjf
耘	rykc
揄	rykj
捡	rykk
拾	ryko
拎	ryld
耱	rylo
捻	rylu
擞	ryms
搂	rymx
抢	ryp
耜	rypu
拖	rypu
耨	rysl
搓	ryth
撙	ryul
耕	ryvi
耖	rywj
耔	rywk
耥	rywo
挫	ryyg
耠	ryyo
耧	ryyx
赍	ryyy
擒	ryzc
耪	ryzd
拉	rz
支	rz
揞	rzb
撞	rzbg
翅	rzdd
擅	rzdk
抗	rzj
觌	rzlb
搔	rzlc
卖	rzlv
搞	rzno
掊	rzo
攘	rzoa
摘	rzro
择	rzrr
摊	rztg
掖	rzts
掠	rzw
搐	rzwd
摔	rzwr
接	rzx
挤	rzxi
搡	rzzm
掇	rzzz
夕	s
旬	sb
厘	sbg
郇	sbp
龟	sbu
厚	sbwk
勾	sc
舛	sci
桀	scim
甸	sd
鱼	sd
匀	sd
鲁	sdb
鲳	sdbb
鳎	sdbd
鲲	sdbf
鲤	sdbg
鳢	sdbh
鲥	sdbl
鳗	sdbz
鲻	sdcd
鲐	sdco
鳔	sdcw
鲴	sddo
鳃	sddu
鲵	sdeb
鲟	sdel
鲫	sdep
鳏	sdfi
鲰	sdfz
鳍	sdgb
鲑	sdgg
鲭	sdgn
鲮	sdgs
鲽	sdhm
鳓	sdhp
鲣	sdig
鲱	sdii
鲇	sdio
鲈	sdip
鳇	sdje
鳐	sdje
稣	sdjm
鲧	sdjw
鳅	sdjy
鲆	sdki
鲡	sdkl
鲠	sdkx
鳊	sdlh
鳙	sdli
鲩	sdnb
鲷	sdno
鳄	sdos
鲒	sdro
鲼	sdry
鲦	sdsm
鲍	sdsu
鳜	sdsy
鳕	sdte
鲕	sdti
鲋	sdtl
色	sdu
鲅	sdvl
鱿	sdvl
鲔	sdvn
鲢	sdvq
鳞	sdyi
鳟	sdyl
鳝	sdyo
鳆	sdys
鲜	sdyt
鲶	sdyu
鳋	sdzc
鲺	sdzc
鲂	sdzd
鲚	sdzi
鲸	sdzw
鲛	sdzx
刍	se
厩	secb
争	sej
邹	sep
皱	sepz
煞	sesw
雏	setg
急	sewu
戊	sfl
压	sgl
厝	shb
劂	shej
厥	shey
厮	shkt
外	si
戚	sikl
蹙	sikv
愿	sjbu
原	sjbw
勿	sjj
刎	sjjj
忽	sjju
与	sk
辰	ska
蜃	skac
辱	skal
唇	skao
厉	skd
励	skdp
威	skfl
戌	skfl
匍	skni
匐	skod
厨	skol
咸	skol
感	skou
欤	sksy
訇	sl
勺	sl
久	sll
灸	slly
戍	slxl
厢	smf
角	sn
触	snc
蟹	sndc
邂	sndq
解	sndr
觚	snjl
觫	snkw
斛	snlr
觖	sntv
夤	snty
奂	snv
觥	snwb
恿	snwu
负	sny
厕	snyj
觞	snyj
觯	snyr
句	so
名	so
免	sob
兔	sobl
勉	sobp
逸	sobq
象	sojc
鸲	sooq
劬	sopp
够	soss
厄	sp
眢	spf
鸳	spoq
历	spp
顾	spty
怨	spwu
螽	sqcc
逄	sqcq
备	sqd
惫	sqdu
处	sqi
昝	sqib
咎	sqio
冬	sqll
条	sqm
各	sqo
雒	sqog
务	sqpp
逢	sqrq
多	ss
乌	ssk
邬	sskp
危	ssp
詹	ssyl
厅	st
厦	stfs
雁	sttg
赝	stty
包	suu
刨	suuj
厌	svl
餍	svla
魇	svlc
厣	svli
靥	svlo
然	svlw
厍	svr
尔	sw
玺	swel
迩	swq
匆	sx
匈	sxu
欠	sy
仄	sy
飧	syla
炙	syy
丁	t
依	ta
百	tb
倡	tbb
俚	tbg
伸	tbi
但	tbk
倮	tbm
偶	tbnc
偈	tbsq
佻	tbx
己	tc
僭	tcbb
偃	tcbx
傈	tccm
僳	tccm
侄	tcg
倒	tcgj
伢	tci
侔	tcjr
低	tckl
似	tcly
仰	tcp
改	tcs
忌	tcwu
伛	tcx
俊	tcys
俟	tcyv
佤	tczl
佃	td
偎	tda
儡	tddd
伺	tdko
仞	tdl
俑	tdn
面	tdo
仙	te
倪	teeb
伊	tej
侵	tenz
健	terq
催	tetg
化	tf
已	tf
仳	tff
偕	tffb
儇	tfka
戛	tfkl
货	tfny
佴	tfr
华	tfr
敢	tfrs
憨	tfru
夏	tfs
倾	tfty
丑	tg
傲	tgds
佳	tgg
佬	tgjf
仨	tgk
倩	tgn
债	tgny
伟	tgp
侍	tgrl
佞	tgx
五	th
借	thb
吾	tho
伴	thr
儆	thss
偌	thvo
倦	thvp
供	thy
侯	thyv
丌	ti
仆	ti
倬	tibr
俜	tids
候	tihv
俳	tii
佧	tiki
侦	tiny
攸	tis
修	tisj
倏	tisl
悠	tisu
仉	tj
伯	tjb
傀	tjbc
俾	tjbi
仫	tjc
傻	tjds
佩	tjke
俐	tjmj
倭	tjmx
仟	tjr
凭	tjrj
任	tjrk
伥	tjrl
俄	tjrl
件	tjrr
恁	tjru
赁	tjry
侨	tjvi
佚	tjvv
仍	tjw
俘	tjwk
工	tk
便	tkbx
僵	tkdk
侥	tkfb
垡	tkfg
伐	tkfl
侠	tkhy
俅	tkil
俨	tkis
仁	tkk
傅	tknl
俪	tknl
俩	tkny
使	tkox
例	tksj
袋	tkua
岱	tkue
代	tkul
牮	tkur
黛	tkuw
贷	tkuy
仗	tkx
信	tl
住	tle
储	tlgb
们	tln
偏	tlph
伪	tlpl
俯	tlsl
休	tm
体	tmk
鸺	tmoq
佣	tn
侬	tna
佗	tnf
倜	tngo
而	tnii
耐	tnil
恧	tniu
耍	tnix
傧	tnjy
伫	tnk
侗	tnko
俱	tnky
鸸	tnoq
倌	tnpu
页	tny
倥	tnyh
侧	tnyj
可	to
仲	toi
侃	toju
俣	tokv
保	tom
堡	tomg
煲	tomy
侣	too
哥	toto
歌	toty
促	tov
倔	tpeu
伲	tpf
假	tpgz
书	tpl
僻	tpor
仂	tpp
伽	tppo
倨	tpro
他	tpu
什	tr
偾	trhy
仕	trk
佶	trko
僖	trko
付	trl
值	trnk
估	tro
做	tros
伎	trz
马	ts
骥	tsay
骒	tsbm
骝	tscd
骖	tscj
骀	tsco
骏	tscs
骠	tscw
驱	tscx
驷	tsdb
骡	tsdw
骤	tsfi
骈	tshh
骐	tshy
骋	tsis
骄	tsji
驯	tsji
骢	tsju
骁	tskb
骊	tskl
骟	tsld
驻	tsle
骗	tslh
驴	tslp
驼	tsnf
驵	tsnk
佝	tso
像	tsoc
驶	tsox
骣	tspk
驰	tspu
佟	tsql
侈	tss
驺	tsse
儋	tssl
驹	tsso
骆	tsso
骓	tstg
驸	tstl
骅	tstr
驮	tsv
骑	tsvo
你	tsw
您	tswu
偬	tsxu
驳	tsxx
验	tsyk
驭	tsz
骧	tsza
骚	tszc
驿	tszr
骇	tszy
仃	tt
佰	ttb
伍	tth
顶	ttny
何	tto
儒	ttxi
僬	ttzw
仇	tu
无	tu
俺	tvbu
传	tvd
侉	tvgs
佐	tvh
傣	tvi
伏	tvl
侑	tvn
佑	tvo
俦	tvrl
俸	tvrr
倚	tvto
优	tvul
僚	tvyw
佛	twji
仔	twk
俏	twn
傥	twnb
偿	twnc
倘	twno
雨	tx
雷	txd
雪	txe
霓	txeb
雩	txgs
傺	txgw
霸	txhn
霰	txhs
霈	txie
霏	txii
霾	txjg
霆	txjq
仪	txl
霭	txlq
霜	txmf
霖	txmm
露	txoo
酃	txop
霹	txpr
霞	txpz
震	txsa
雳	txsp
雾	txsp
雹	txsu
霍	txtg
需	txti
颥	txty
霄	txwn
零	txyd
霉	txyr
霁	txzi
霎	txzx
雯	txzx
份	tyd
僧	tydb
侮	tydr
伦	tyf
价	tyji
作	tyk
侩	tykc
偷	tykj
俭	tykk
伶	tyld
侏	tym
偻	tymx
佾	tyn
伧	typ
伤	typp
仵	tyr
佯	tyt
伙	tyy
俗	tyyo
仡	tyz
仅	tz
位	tz
亿	tz
僮	tzbg
仿	tzd
隹	tzg
雠	tzgg
劁	tzgj
集	tzgm
售	tzgo
隼	tzgr
焦	tzgw
隽	tzgw
伉	tzj
停	tznt
倍	tzo
鹪	tzoq
傩	tztg
僦	tzwl
侪	tzxi
佼	tzyx
傍	tzzd
九	u
旮	ub
旭	ub
醌	ubff
醴	ubih
醒	ubjg
醍	ubkv
酸	ucys
醪	uddj
酯	ufb
酵	ugjk
醋	uhb
馗	uhjf
酣	uhk
醛	uhye
酬	uiii
醭	uiiv
匕	uj
酰	ujgb
酷	ujgo
醺	ujkw
酥	ujm
酹	ujrl
酝	ukc
酽	ukis
酾	uknl
酐	ukr
丸	ul
醯	ulch
酿	ulea
醣	ulso
杂	um
酡	unf
酮	unko
酲	uoe
鸠	uoq
醵	upfc
酏	upu
酎	url
酤	uro
醐	uron
弓	us
收	us
酌	usl
酩	uso
酪	usqo
酊	ut
爿	ut
配	utc
醮	utzw
凹	uu
巳	uu
兕	uub
异	uuh
导	uurl
巽	uuuy
酞	uvl
醢	uvoh
酗	uxu
酚	uyd
酶	uydr
酢	uyk
酴	uykm
醚	uymq
醅	uzo
醑	uzvn
醇	uzwk
醉	uzyr
大	v
春	vb
蠢	vbcc
鹌	vboq
奄	vbu
雄	vctg
奁	vcx
奋	vd
专	vd
布	ve
舂	vee
此	vf
套	vf
些	vfg
砦	vfko
龙	vfl
訾	vfl
袭	vfla
垄	vflg
砻	vflo
聋	vflr
龚	vfly
柴	vfm
赀	vfny
耷	vfr
觜	vfsn
雌	vftg
紫	vfww
奎	vgg
奢	vgjb
夸	vgs
刳	vgsj
瓠	vgsl
匏	vgsu
奈	vgw
左	vh
井	vi
泰	vi
在	vig
步	vij
颦	viji
频	vijy
进	viq
存	viwk
夼	vjii
秦	vjm
奏	vkv
犬	vl
太	vl
飙	vlvx
态	vlwu
肯	vn
有	vn
牵	vnjr
郁	vnp
右	vo
邦	vp
帮	vpe
夯	vpp
达	vq
车	vr
辊	vrbf
辎	vrcd
轾	vrcg
轹	vrcw
轫	vrdl
轺	vrdo
辄	vrfu
辕	vrga
奔	vrh
轴	vrid
轳	vrip
暂	vrjb
堑	vrjg
轿	vrji
轷	vrjj
椠	vrjm
錾	vrjq
斩	vrjt
轶	vrjv
辐	vrkd
辅	vrki
轼	vrkl
轩	vrkr
辆	vrky
夺	vrl
寿	vrl
辘	vrlf
辙	vrls
焘	vrlw
辋	vrnc
辖	vrno
辑	vror
轵	vroy
辗	vrpa
连	vrq
奉	vrr
轱	vrro
辂	vrso
轭	vrsp
软	vrsy
轲	vrto
轨	vru
轧	vru
舆	vruy
转	vrvd
辏	vrvv
辁	vrye
轮	vryf
辚	vryi
输	vryj
轸	vryj
歧	vrz
轻	vrzh
较	vrzx
辍	vrzz
轰	vrzz
奇	vto
剞	vtoj
欹	vtoy
尢	vu
尴	vuih
尤	vul
尥	vusl
尬	vuyi
夫	vv
规	vvnb
替	vvvb
辇	vvvr
东	vw
鸫	vwoq
爽	vxxx
鹩	vyoq
齿	vyu
龈	vyua
龋	vyuc
龄	vyud
龀	vyuf
龇	vyuf
龌	vyug
龃	vyuk
龆	vyuo
龉	vyuo
龅	vyuu
龊	vyuv
灰	vyy
盔	vyyh
麴	vyym
友	vz
发	vzl
了	w
忾	waz
绲	wbff
慢	wbfz
缦	wbfz
悝	wbg
绅	wbi
惺	wbjg
怛	wbk
悍	wbkr
缇	wbkv
愠	wbnh
惕	wbsj
憬	wbzw
弘	wc
缁	wccd
缫	wccm
缥	wccw
缘	wchc
纸	wcku
惬	wcky
怡	wco
绐	wco
惨	wcvj
怄	wcx
悛	wcys
忉	wd
幻	wd
细	wd
缪	wddj
纫	wdl
悃	wdm
怊	wdo
绍	wdo
惯	wdry
弱	wdwd
缌	wdwu
缧	wdww
纾	wdzj
当	we
恨	wea
慨	weab
绿	wei
恺	wetc
惴	weti
绌	weu
必	wf
纰	wff
缳	wfka
缎	wfkz
弭	wfr
慑	wfrz
缈	wfwj
愣	wfzd
尘	wg
线	wgfl
悻	wghr
绪	wgjb
疆	wgkk
承	wgkx
情	wgn
绩	wgny
纬	wgp
恃	wgrl
愫	wgww
绫	wgys
红	wh
惜	whb
慊	whei
缣	whei
懵	whff
懂	whjg
绀	whk
慌	whlu
缂	whor
绁	whq
绊	whr
绻	whvp
缢	whyh
引	wi
悼	wibr
绰	wibr
悱	wii
绯	wii
缆	wiib
悭	wiig
少	wj
乡	wj
怕	wjb
愧	wjbc
惶	wjbe
绵	wjbe
缴	wjbs
弧	wjcl
省	wjf
性	wjg
缵	wjgy
弗	wji
艴	wjiu
费	wjiy
缍	wjkg
悸	wjmk
愀	wjmy
恤	wjnh
懊	wjnv
绶	wjnz
劣	wjpp
缒	wjpq
级	wjq
忏	wjr
纤	wjr
怅	wjrl
张	wjrl
恬	wjro
忻	wjt
绗	wjtt
缓	wjtz
绥	wjx
飨	wjya
孑	wk
子	wk
光	wkb
耀	wkbg
恒	wkbk
辉	wkbr
绠	wkbx
纭	wkc
恸	wkcp
缰	wkdk
纯	wke
绕	wkfb
怦	wkhi
缙	wkib
孤	wkjl
孟	wknh
缚	wknl
勐	wknp
悚	wkow
懒	wkoy
纡	wkr
孜	wks
孢	wksu
孺	wkti
孔	wku
怔	wkv
绒	wkvl
怀	wkw
孙	wkw
逊	wkwq
兴	wky
誉	wkyl
举	wkyr
孩	wkzy
幺	wl
忙	wlc
统	wlcb
孓	wll
悯	wlnx
编	wlph
纩	wls
缠	wlsg
慷	wlsi
慵	wlsi
惦	wlso
缃	wmf
怵	wml
憷	wmmv
肖	wn
忱	wnb
惆	wngo
绸	wngo
综	wngw
惘	wnhc
黉	wnhy
泶	wni
削	wnj
喾	wnjo
缤	wnjy
组	wnk
尝	wnkc
恫	wnko
绽	wnkv
惧	wnky
绷	wnn
觉	wnnb
尚	wno
裳	wnoa
党	wnob
常	wnoe
氅	wnof
堂	wnog
棠	wnom
掌	wnor
敞	wnos
赏	wnoy
绾	wnpu
逍	wnq
鲎	wnsd
惋	wnsp
缩	wntb
怏	wnv
恽	wnvr
学	wnwk
纲	wnx
纳	wny
恻	wnyj
缨	wnyx
绳	wobu
强	woc
犟	wocr
悒	wodu
缉	wofr
缱	wogq
愦	wogy
缋	wogy
忡	woi
绢	won
缲	woom
愕	woos
织	woy
亟	wozk
怩	wpf
缗	wpkb
幼	wpp
弛	wpu
辽	wq
怯	wrc
愤	wrhy
结	wrko
缬	wrky
忖	wrl
纣	wrl
悖	wrnk
慎	wrny
缜	wrny
怙	wro
忮	wrz
续	wrzv
恂	wsb
绚	wsb
绝	wsdu
绉	wse
惚	wsju
缄	wskl
缛	wskl
憾	wsku
约	wsl
懈	wsnr
绛	wsqi
终	wsql
绦	wsqm
恪	wsqo
绺	wsqo
络	wsqo
缝	wsqq
恹	wsvl
弥	wsw
弼	wtbw
纪	wtc
缅	wtdo
忸	wtg
纽	wtg
悟	wtho
缑	wthv
缏	wtkx
惟	wttg
怃	wtu
快	wtv
懦	wtxi
雀	wtzg
维	wtzg
憔	wtzw
纠	wu
心	wu
纨	wul
尖	wv
练	wvdy
怖	wve
绔	wvgs
惰	wvhn
绑	wvp
辔	wvro
惭	wvrt
绮	wvto
忧	wvul
尜	wvw
缭	wvyw
恢	wvyy
绂	wvzl
糸	ww
幽	wwe
纱	wwj
怫	wwji
绋	wwji
丝	wwk
恍	wwkb
畿	wwkl
悄	wwn
绡	wwn
惝	wwno
绱	wwno
鸶	wwoq
丞	wxk
卺	wxkp
函	wxu
弹	wybr
愎	wybs
忪	wyc
纷	wyd
憎	wydb
缯	wydb
悔	wydr
纶	wyf
怍	wyk
绘	wykc
愉	wykj
恰	wyko
给	wyko
怜	wyld
鬻	wymi
继	wymq
粥	wymw
缕	wymx
悦	wyob
怆	wyp
忤	wyr
缮	wyto
悌	wywi
绨	wywi
纵	wyy
纥	wyz
忆	wz
憧	wzbg
纺	wzd
懔	wzdw
缔	wze
怪	wzg
经	wzh
弪	wzh
忭	wzi
缟	wzno
惊	wzow
怿	wzrr
绎	wzrr
弦	wzw
纹	wzx
缡	wzxc
恼	wzxu
悴	wzyr
绞	wzyx
缀	wzzz
女	x
娼	xbb
娌	xbg
妲	xbk
媪	xbnh
姚	xbx
嫖	xccw
婚	xckb
姒	xcly
始	xco
妪	xcx
姬	xcy
媚	xdjf
姆	xdr
姻	xdv
娜	xdvp
嫘	xdww
妤	xdzj
妇	xe
嫂	xeez
媸	xekc
妣	xff
婊	xga
娃	xgg
姥	xgjf
婧	xgn
祭	xgw
嫫	xhbv
嫌	xhei
姘	xhh
媒	xhkm
媾	xhng
妯	xid
娉	xids
刈	xj
猖	xjbb
狸	xjbg
猩	xjbg
婢	xjbi
猓	xjbm
独	xjc
狁	xjcb
狻	xjcs
猥	xjda
猸	xjdf
媲	xjdf
狎	xjdi
猱	xjdm
猬	xjdn
狂	xje
狠	xjea
猊	xjeb
逛	xjeq
狴	xjfg
猡	xjfs
媳	xjfu
姓	xjg
猿	xjga
猪	xjgb
橥	xjgm
猜	xjgn
猎	xjhb
猫	xjhd
獾	xjhg
狮	xjie
猁	xjjj
狐	xjjl
獯	xjjw
狨	xjkl
犴	xjkr
獭	xjky
狭	xjky
狺	xjl
狼	xjla
狱	xjll
犷	xjls
猹	xjmk
狙	xjnk
狩	xjnl
猾	xjnn
狞	xjnt
狈	xjny
嫒	xjnz
狷	xjon
犯	xjp
妊	xjrk
娥	xjrl
猢	xjrn
狰	xjsj
狗	xjso
獬	xjsr
狍	xjsu
獗	xjsy
狃	xjtg
犸	xjts
猴	xjtv
媛	xjtz
犰	xju
妖	xjv
娇	xjvi
犹	xjvl
猗	xjvo
獠	xjvw
奶	xjw
猛	xjwh
狒	xjwi
猕	xjww
狲	xjww
狯	xjyc
猃	xjyk
狳	xjym
猞	xjyo
逖	xjyq
狄	xjyy
獍	xjzb
猝	xjzr
獐	xjzr
狡	xjzx
婕	xkev
娆	xkfb
妍	xkh
娅	xkik
妹	xkm
登	xkoh
凳	xkoj
嫩	xkos
奸	xkr
癸	xkv
嫣	xkvw
姨	xkwy
义	xl
娘	xlea
娴	xlnm
妒	xlp
妫	xlpl
嬷	xlsc
杀	xm
刹	xmj
弑	xmkl
婶	xnbi
姹	xnjf
嫔	xnjy
姐	xnk
嫁	xnkc
姗	xnnk
婉	xnsp
如	xo
娱	xokv
娟	xon
娲	xony
恕	xowu
絮	xoww
妮	xpf
娓	xpjf
婀	xpto
她	xpu
嫉	xpyv
嫱	xrho
嬉	xrko
姑	xro
妓	xrz
姊	xsi
娠	xska
妁	xsl
娩	xsob
妃	xtc
妞	xtg
妈	xts
妩	xtu
孀	xtxf
凶	xu
鬯	xuf
郄	xvcp
希	xve
郗	xvep
欷	xvey
肴	xvn
妙	xwj
好	xwk
嫦	xwne
爻	xx
婵	xybr
妗	xylz
姝	xym
娣	xywi
奴	xz
嫜	xzbr
妨	xzd
嬗	xzdk
帑	xze
婷	xznt
胬	xzny
努	xzpp
嫡	xzro
驽	xzts
婿	xzvn
弩	xzw
孥	xzwk
怒	xzwu
姣	xzyx
人	y
单	ybr
冁	ybra
郸	ybrp
复	ybs
公	yc
瓮	yccl
翁	ycdd
年	yci
颂	ycty
分	yd
岔	yde
坌	ydg
兽	ydko
盆	ydnh
贫	ydny
每	ydr
敏	ydrs
毓	ydru
繁	ydrw
鳘	ydsd
颁	ydty
曾	ydwb
甑	ydwl
忿	ydwu
全	ye
羌	yeb
羡	yedy
羲	yejl
盖	yenh
鳖	yesd
美	yev
羔	yew
恙	yewu
羹	yewv
姜	yex
瞥	yeyf
弊	yeyh
敝	yeys
憋	yeyu
蹩	yeyv
仑	yf
佘	ygw
畲	ygwd
仝	yh
伞	yhi
舞	yhsi
个	yi
氽	yi
丫	yi
介	yji
乍	yk
会	ykc
刽	ykcj
郐	ykcp
余	ykm
途	ykmq
斜	ykmr
叙	ykmz
觎	yknb
毹	yknf
俞	yknj
逾	yknq
愈	yknu
合	yko
翕	ykod
盒	ykoh
龠	ykoh
龛	ykol
命	ykop
鸽	ykoq
拿	ykor
颌	ykoy
歙	ykoy
迮	ykq
舒	ykrj
舍	ykro
兮	yks
剑	ykwj
佥	ykwk
敛	ykws
怎	ykwu
令	yld
翎	yldd
瓴	yldl
邻	yldp
领	yldy
食	ylea
今	ylz
衾	ylza
含	ylzo
念	ylzu
颔	ylzy
贪	ylzy
米	ym
朱	ym
粞	ymcc
糁	ymcj
糅	ymdm
粑	ymdu
籼	yme
精	ymgn
糟	ymhb
糍	ymhw
粪	ymhy
粘	ymio
粕	ymjb
糗	ymjl
糙	ymjq
粳	ymkx
粮	ymla
糠	ymli
糖	ymlo
料	ymlr
粗	ymnk
粽	ymnw
邾	ymp
迷	ymq
断	ymqt
糊	ymrn
敉	yms
糌	ymsb
粼	ymsc
粝	ymsd
遴	ymsq
糯	ymti
糇	ymtv
类	ymv
糨	ymwc
籽	ymwk
娄	ymx
数	ymxs
粉	ymyd
糕	ymyw
粒	ymz
糈	ymzn
粹	ymzr
兑	yob
总	yowu
仓	yp
创	ypj
戗	ypkl
迤	ypuq
午	yr
迕	yrq
羊	yt
羯	ytbq
羝	ytcl
羧	ytcs
翔	ytdd
羰	ytey
着	ytf
差	yth
善	ytho
鄯	ythp
养	ytli
羞	yttg
羚	ytyd
羟	ytzh
酋	yu
遒	yuq
尊	yurl
遵	yurq
奠	yuv
猷	yuvl
企	yv
矢	yv
榘	yvcm
矩	yvcu
判	yvj
矫	yvji
叛	yvjs
矮	yvjx
短	yvkh
知	yvo
智	yvob
雉	yvtg
矧	yvwi
矬	yvyg
弟	ywi
剃	ywij
递	ywiq
鹈	ywoq
父	yx
爸	yxdu
斧	yxjt
釜	yxkh
脊	yxn
爷	yxp
爹	yxss
从	yy
火	yy
爆	yybi
焊	yybr
熳	yybz
煜	yybz
烛	yyc
熘	yycd
炬	yycu
烁	yycw
煨	yyda
熠	yydb
烟	yydv
灿	yye
煺	yyeq
耸	yyfr
煅	yyfz
灶	yyg
坐	yyg
炜	yygp
烤	yygs
烂	yyhk
煤	yyhm
燧	yyhq
烘	yyhy
焯	yyir
燔	yyjd
煌	yyje
烀	yyjj
爝	yyjl
熄	yyju
燠	yyjv
丛	yyk
烧	yykb
炖	yyke
炻	yyko
炳	yyky
煽	yyld
炷	yyle
煸	yylh
炉	yylp
焖	yylu
燮	yylz
烷	yynb
煊	yynk
俎	yynk
炯	yyno
熔	yyno
谷	yyo
燥	yyom
鹆	yyoq
炽	yyoy
欲	yyoy
烬	yypl
煳	yyrn
焰	yyse
灼	yysl
烙	yyso
烽	yysr
炮	yysu
焕	yysv
燃	yysw
炊	yysy
灯	yyt
焐	yyto
烨	yytr
炔	yytv
烦	yyty
燎	yyvw
炼	yyvy
炒	yywj
炀	yywj
怂	yywu
烯	yyxe
众	yyy
烩	yyyc
剡	yyyj
炸	yyyk
焓	yyyo
炝	yyyp
郯	yyyp
烊	yyyt
炎	yyyy
焱	yyyy
烃	yyzh
炕	yyzj
焙	yyzo
熵	yyzo
炫	yyzw
乞	yz
迄	yzq
禽	yzxc
乙	z
哀	za
音	zb
竟	zbb
韶	zbdo
童	zbg
裹	zbma
章	zbr
彰	zbrj
鄣	zbrp
戆	zbru
赣	zbry
韵	zbsd
竭	zbsq
歆	zbsy
意	zbwu
飞	zc
竣	zcys
方	zd
亩	zd
翊	zddd
禀	zdow
颤	zdoy
邡	zdp
劢	zdpp
放	zds
旅	zdya
旆	zdye
旄	zdyf
旎	zdyf
旌	zdyg
於	zdyl
膂	zdyn
旖	zdyo
旒	zdyu
施	zdyu
旋	zdyv
族	zdyv
旗	zdyy
旃	zdyz
袤	zdza
帝	ze
市	ze
艰	zea
裒	zeea
啻	zeo
端	zeti
圣	zg
靖	zgn
立	zh
刭	zhj
巯	zhlu
劲	zhpp
迳	zhq
颈	zhty
卞	zi
衷	zia
亦	zii
蛮	ziic
峦	ziie
弈	ziih
孪	ziik
栾	ziim
迹	ziiq
銮	ziiq
挛	ziir
恋	ziiu
奕	ziiv
弯	ziiw
娈	ziix
脔	ziiy
变	ziiz
站	zio
鸾	zioq
产	zj
亢	zj
虱	zjc
毅	zjcz
彦	zjjj
颜	zjjy
颃	zjty
飒	zjx
衰	zka
戏	zkfl
竦	zkow
叉	zl
蚤	zlc
又	zll
买	zllv
亲	zm
新	zmjt
观	znb
亮	znj
亳	znjf
毫	znjf
豪	znkc
高	zno
膏	znon
敲	znoz
亭	znt
竞	zob
瓿	zocl
襄	zoha
瓤	zohl
剖	zoj
部	zop
鸡	zoq
邓	zp
劝	zpp
辛	zr
对	zrl
怼	zrlu
迅	zrq
亵	zrua
欢	zsy
褒	ztoa
夜	zts
难	ztzg
亥	zuy
刻	zuyj
劾	zuyp
颏	zuyy
疋	zv
蛋	zvc
辨	zvir
瓣	zvjr
辣	zvkw
辩	zvlr
疏	zvlu
胥	zvn
辫	zvwr
亨	zw
京	zw
玄	zw
畜	zwd
饔	zwja
雍	zwjg
壅	zwjg
享	zwk
塾	zwkg
孰	zwkl
郭	zwkp
敦	zwks
憝	zwku
熟	zwkw
鹑	zwoq
鹫	zwoq
就	zwvl
烹	zww
率	zwxr
妾	zx
文	zx
斌	zxgl
齑	zxii
刘	zxj
齐	zxji
剂	zxjj
斓	zxlw
吝	zxo
这	zxq
斋	zxti
离	zxuc
紊	zxww
六	zy
衮	zyca
兖	zycb
商	zyo
交	zyx
郊	zyxp
效	zyxs
卒	zyyr
双	zz
旁	zzd
叠	zzzk
桑	zzzm
颡	zzzy
镕	qnyo
瞭	fvyw
矇	fhnc
眬	fvfl
啰	ofs
焗	yypo
槃	nrjm
屌	poe
咁	ohk
嘢	obgj
瑄	enkk
甪	jn
旻	bzx
磡	kohp
喆	rkoo
硚	koji
啫	ogjb
玥	en
𬎆	ehnl
𬱖	idty
漷	izwp
俵	tga
倴	tvrh
獏	xjhv
洺	iso
塚	gnkc
鄚	hbvp
泃	iso
墕	gkvw
虒	spfj
浛	iylo
洸	iwkb
畖	djcl
磑	koek
勍	zwpp
奤	vtdo
啟	lpos
砄	kotv
濛	ihkc
㳇	iyx
栟	mhh
弶	wzw
氾	ip
澥	isnr
甽	djii
峃	wne
旸	bwjj
垟	gyt
浬	ibg
昇	bjh
崷	eyu
峇	eyko
垵	gnx
漈	ixgw
沚	iv
埇	gdn
垾	gbkr
烔	yyno
堨	gbsq
鲖	sdno
堌	gdro
琯	enpu
菉	hei
洑	itvl
萩	hjmy
岞	eyk
磻	kojd
垱	gwe
瀼	izoa
㙦	ykmg
垇	guu
璪	eoom
塅	gfkz
玕	ekr
旴	bkr
昄	bjs
鄌	lsep
郚	thop
堽	gfkv
浉	iije
贠	cny
滍	iekc
垕	jkog
禇	agjb
酂	jgbp
猇	xjpj
漋	ipsg
剅	kohj
涴	insp
洈	issp
塝	gzzd
澴	ifka
舲	nryd
洣	iym
姞	xrko
崟	eq
坵	gjo
埗	gvij
崀	elea
梽	mrku
筀	aagg
湴	ihik
壇	gzdk
堧	gtnv
崙	eykh
廻	doq
篢	aahy
溇	iymx
碕	kovo
砠	konk
迴	doq
復	jtys
雲	txkc
岺	eyld
沺	id
枹	tsuu
碁	hkyo
磜	koxw
荖	hgjf
㙍	gzzz
鮜	sdjo
浰	ijmj
汫	ivi
簕	aahp
榃	mmd
硍	koea
埌	glea
蔈	hccw
䢺	eup
荄	hzuy
郪	rexp
椑	mjbi
荍	hus
牂	kyt
牁	kto
㯊	mkvw
磏	kohi
骔	tsnw
闇	nzb
竜	zbu
脿	nga
嘠	otfl
鄠	txgp
洩	ibf
邽	ggp
崄	eykk
朳	my
汭	iny
巉	esol
癿	jbu
𨳇  kpkp

